id	Year	Period	labor force participation rate	employment-population ratio	labor force	employment	unemployment	unemployment rate
1	2010	Jan	59	52.1	2144182	1893169	251013	11.7
1	2010	Feb	58.9	52.1	2143881	1895920	247961	11.6
1	2010	Mar	58.9	52.2	2142133	1898914	243219	11.4
1	2010	Apr	59.6	53.2	2202028	1964959	237069	10.8
1	2010	May	59.9	53.7	2215715	1985529	230186	10.4
1	2010	Jun	59.8	53.8	2215606	1991532	224074	10.1
1	2010	Jul	59.7	53.8	2212806	1992510	220296	10
1	2010	Aug	59.6	53.7	2211477	1991908	219569	9.9
1	2010	Sep	59.6	53.7	2212523	1990948	221575	10
1	2010	Oct	59.7	53.6	2215139	1990369	224770	10.1
1	2010	Nov	59.7	53.6	2217545	1990270	227275	10.2
1	2010	Dec	59.7	53.6	2218306	1990304	228002	10.3
1	2011	Jan	59.7	53.5	2217245	1990151	227094	10.2
1	2011	Feb	59.6	53.5	2214781	1989525	225256	10.2
1	2011	Mar	59.5	53.5	2211546	1988337	223209	10.1
1	2011	Apr	59.4	53.4	2208494	1986912	221582	10
1	2011	May	59.3	53.4	2206536	1985926	220610	10
1	2011	Jun	59.2	53.3	2205399	1985894	219505	10
1	2011	Jul	59.2	53.4	2204490	1987195	217295	9.9
1	2011	Aug	59.1	53.4	2202706	1989639	213067	9.7
1	2011	Sep	59	53.4	2198917	1992593	206324	9.4
1	2011	Oct	58.8	53.5	2193291	1995331	197960	9
1	2011	Nov	58.6	53.5	2186335	1997246	189089	8.6
1	2011	Dec	58.4	53.5	2179075	1998090	180985	8.3
1	2012	Jan	58.2	53.5	2173177	1998157	175020	8.1
1	2012	Feb	58.1	53.5	2170249	1998044	172205	7.9
1	2012	Mar	58.1	53.4	2170701	1997949	172752	8
1	2012	Apr	58.1	53.4	2173301	1997920	175381	8.1
1	2012	May	58.2	53.4	2176682	1998414	178268	8.2
1	2012	Jun	58.2	53.4	2179696	1999858	179838	8.3
1	2012	Jul	58.2	53.5	2181117	2002056	179061	8.2
1	2012	Aug	58.2	53.5	2181066	2004772	176294	8.1
1	2012	Sep	58.2	53.6	2180876	2008050	172826	7.9
1	2012	Oct	58.1	53.6	2181018	2011534	169484	7.8
1	2012	Nov	58.1	53.7	2181645	2014832	166813	7.6
1	2012	Dec	58.1	53.7	2182661	2017815	164846	7.6
1	2013	Jan	58.1	53.7	2181055	2017941	163114	7.5
1	2013	Feb	58	53.7	2180812	2019734	161078	7.4
1	2013	Mar	58	53.8	2179552	2021069	158483	7.3
1	2013	Apr	57.9	53.8	2178107	2022206	155901	7.2
1	2013	May	57.9	53.8	2176524	2022526	153998	7.1
1	2013	Jun	57.8	53.7	2174765	2021523	153242	7
1	2013	Jul	57.7	53.6	2173167	2019444	153723	7.1
1	2013	Aug	57.6	53.5	2171405	2016769	154636	7.1
1	2013	Sep	57.6	53.4	2169270	2013925	155345	7.2
1	2013	Oct	57.5	53.3	2167625	2011611	156014	7.2
1	2013	Nov	57.5	53.3	2167180	2010357	156823	7.2
1	2013	Dec	57.4	53.3	2167665	2010100	157565	7.3
1	2014	Jan	57.4	53.3	2167589	2010442	157147	7.2
1	2014	Feb	57.4	53.3	2168122	2011318	156804	7.2
1	2014	Mar	57.4	53.3	2167611	2011797	155814	7.2
1	2014	Apr	57.3	53.2	2165472	2011409	154063	7.1
1	2014	May	57.2	53.2	2162335	2010805	151530	7
1	2014	Jun	57.1	53.2	2159591	2011006	148585	6.9
1	2014	Jul	57.1	53.2	2157687	2012088	145599	6.7
1	2014	Aug	57	53.2	2156791	2013967	142824	6.6
1	2014	Sep	57	53.3	2156474	2016370	140104	6.5
1	2014	Oct	56.9	53.3	2155862	2018798	137064	6.4
1	2014	Nov	56.9	53.3	2154576	2020730	133846	6.2
1	2014	Dec	56.8	53.4	2153458	2022147	131311	6.1
1	2015	Jan	56.9	53.4	2155229	2025225	130004	6
1	2015	Feb	56.9	53.4	2156195	2026213	129982	6
1	2015	Mar	56.9	53.5	2158191	2027365	130826	6.1
1	2015	Apr	57	53.5	2160755	2028665	132090	6.1
1	2015	May	57	53.5	2162849	2029647	133202	6.2
1	2015	Jun	57	53.5	2163514	2029908	133606	6.2
1	2015	Jul	57	53.4	2162981	2029739	133242	6.2
1	2015	Aug	56.9	53.4	2162075	2029663	132412	6.1
1	2015	Sep	56.9	53.4	2161765	2030331	131434	6.1
1	2015	Oct	56.9	53.4	2162971	2032300	130671	6
1	2015	Nov	56.9	53.5	2165764	2035509	130255	6
1	2015	Dec	57	53.6	2169206	2039299	129907	6
1	2016	Jan	57.1	53.7	2172388	2042932	129456	6
1	2016	Feb	57.1	53.7	2174756	2045861	128895	5.9
1	2016	Mar	57.1	53.8	2175985	2047937	128048	5.9
1	2016	Apr	57.1	53.8	2176610	2049567	127043	5.8
1	2016	May	57.1	53.8	2177744	2051324	126420	5.8
1	2016	Jun	57.2	53.8	2179914	2053478	126436	5.8
1	2016	Jul	57.2	53.9	2182979	2056026	126953	5.8
1	2016	Aug	57.3	53.9	2186380	2058626	127754	5.8
1	2016	Sep	57.3	54	2189475	2060940	128535	5.9
1	2016	Oct	57.4	54	2191550	2062982	128568	5.9
1	2016	Nov	57.4	54	2192334	2065186	127148	5.8
1	2016	Dec	57.3	54.1	2191838	2067861	123977	5.7
1	2017	Jan	57.3	54.2	2190329	2071081	119248	5.4
1	2017	Feb	57.2	54.2	2188348	2074705	113643	5.2
1	2017	Mar	57.1	54.3	2186288	2078249	108039	4.9
1	2017	Apr	57.1	54.4	2184662	2081749	102913	4.7
1	2017	May	57	54.5	2183769	2085452	98317	4.5
1	2017	Jun	57	54.5	2183742	2089327	94415	4.3
1	2017	Jul	57	54.6	2184590	2093230	91360	4.2
1	2017	Aug	57	54.7	2185775	2096855	88920	4.1
1	2017	Sep	57	54.8	2186882	2099944	86938	4
1	2017	Oct	57	54.8	2187906	2102409	85497	3.9
1	2017	Nov	57	54.8	2189013	2104285	84728	3.9
1	2017	Dec	57.1	54.9	2190664	2106038	84626	3.9
1	2018	Jan	57.1	54.9	2193503	2108270	85233	3.9
1	2018	Feb	57.2	55	2197940	2111603	86337	3.9
1	2018	Mar	57.4	55.1	2203652	2116089	87563	4
1	2018	Apr	57.5	55.2	2209336	2120773	88563	4
1	2018	May	57.6	55.3	2213939	2124833	89106	4
1	2018	Jun	57.7	55.4	2217374	2128455	88919	4
1	2018	Jul	57.7	55.4	2219912	2132025	87887	4
1	2018	Aug	57.8	55.5	2222360	2135951	86409	3.9
1	2018	Sep	57.8	55.6	2225266	2140433	84833	3.8
1	2018	Oct	57.9	55.7	2228692	2145326	83366	3.7
1	2018	Nov	57.9	55.8	2232417	2150295	82122	3.7
1	2018	Dec	58	55.9	2235806	2154840	80966	3.6
1	2019	Jan	58.1	56	2237931	2158471	79460	3.6
1	2019	Feb	58	56	2238155	2160923	77232	3.5
1	2019	Mar	58	56.1	2237126	2162757	74369	3.3
1	2019	Apr	58	56.1	2236130	2164945	71185	3.2
1	2019	May	57.9	56.2	2236013	2167956	68057	3
1	2019	Jun	57.9	56.3	2237028	2171639	65389	2.9
1	2019	Jul	58	56.3	2239558	2176144	63414	2.8
1	2019	Aug	58	56.4	2242626	2180477	62149	2.8
1	2019	Sep	58.1	56.5	2245766	2184271	61495	2.7
1	2019	Oct	58.1	56.5	2247981	2186771	61210	2.7
1	2019	Nov	58.1	56.5	2248190	2186809	61381	2.7
1	2019	Dec	58.1	56.5	2247886	2186356	61530	2.7
1	2020	Jan	58.1	56.5	2247721	2186652	61069	2.7
1	2020	Feb	58	56.4	2243967	2184248	59719	2.7
2	2010	Jan	70.1	64.4	360551	331605	28946	8
2	2010	Feb	70.1	64.4	360671	331758	28913	8
2	2010	Mar	70.1	64.5	360805	331968	28837	8
2	2010	Apr	70	64.4	360965	332248	28717	8
2	2010	May	69.9	64.4	361150	332605	28545	7.9
2	2010	Jun	69.8	64.3	361348	333011	28337	7.8
2	2010	Jul	69.7	64.3	361603	333436	28167	7.8
2	2010	Aug	69.6	64.2	361986	333880	28106	7.8
2	2010	Sep	69.6	64.2	362510	334353	28157	7.8
2	2010	Oct	69.6	64.2	363144	334876	28268	7.8
2	2010	Nov	69.6	64.2	363800	335426	28374	7.8
2	2010	Dec	69.6	64.2	364371	335950	28421	7.8
2	2011	Jan	69.6	64.2	364782	336406	28376	7.8
2	2011	Feb	69.5	64.2	365003	336768	28235	7.7
2	2011	Mar	69.4	64.1	365077	337045	28032	7.7
2	2011	Apr	69.3	64.1	365121	337303	27818	7.6
2	2011	May	69.3	64	365247	337610	27637	7.6
2	2011	Jun	69.2	64	365500	337993	27507	7.5
2	2011	Jul	69.1	64	365887	338432	27455	7.5
2	2011	Aug	69.1	64	366325	338848	27477	7.5
2	2011	Sep	69.1	64	366676	339160	27516	7.5
2	2011	Oct	69.1	63.9	366859	339342	27517	7.5
2	2011	Nov	69	63.9	366844	339398	27446	7.5
2	2011	Dec	68.9	63.8	366674	339373	27301	7.4
2	2012	Jan	68.8	63.7	366425	339328	27097	7.4
2	2012	Feb	68.7	63.7	366158	339301	26857	7.3
2	2012	Mar	68.6	63.6	365907	339291	26616	7.3
2	2012	Apr	68.5	63.6	365649	339247	26402	7.2
2	2012	May	68.4	63.5	365425	339189	26236	7.2
2	2012	Jun	68.3	63.4	365279	339191	26088	7.1
2	2012	Jul	68.2	63.4	365206	339296	25910	7.1
2	2012	Aug	68.2	63.4	365197	339480	25717	7
2	2012	Sep	68.2	63.4	365256	339678	25578	7
2	2012	Oct	68.2	63.4	365327	339822	25505	7
2	2012	Nov	68.1	63.4	365360	339883	25477	7
2	2012	Dec	68.1	63.3	365333	339858	25475	7
2	2013	Jan	68	63.3	365252	339758	25494	7
2	2013	Feb	68	63.2	365142	339624	25518	7
2	2013	Mar	67.9	63.2	365061	339539	25522	7
2	2013	Apr	67.9	63.2	365073	339583	25490	7
2	2013	May	67.9	63.2	365154	339715	25439	7
2	2013	Jun	67.9	63.2	365262	339843	25419	7
2	2013	Jul	67.9	63.1	365373	339939	25434	7
2	2013	Aug	67.8	63.1	365454	340011	25443	7
2	2013	Sep	67.8	63.1	365511	340073	25438	7
2	2013	Oct	67.8	63.1	365552	340102	25450	7
2	2013	Nov	67.8	63.1	365597	340104	25493	7
2	2013	Dec	67.8	63.1	365674	340129	25545	7
2	2014	Jan	67.8	63.1	365570	340015	25555	7
2	2014	Feb	67.9	63.1	365748	340179	25569	7
2	2014	Mar	67.9	63.1	365935	340355	25580	7
2	2014	Apr	67.9	63.1	366066	340463	25603	7
2	2014	May	67.9	63.1	366094	340486	25608	7
2	2014	Jun	67.8	63.1	365994	340451	25543	7
2	2014	Jul	67.8	63.1	365747	340360	25387	6.9
2	2014	Aug	67.7	63	365398	340264	25134	6.9
2	2014	Sep	67.6	63	365010	340227	24783	6.8
2	2014	Oct	67.5	62.9	364676	340294	24382	6.7
2	2014	Nov	67.4	63	364432	340430	24002	6.6
2	2014	Dec	67.4	63	364273	340562	23711	6.5
2	2015	Jan	67.3	63	364114	340583	23531	6.5
2	2015	Feb	67.3	62.9	364029	340541	23488	6.5
2	2015	Mar	67.3	62.9	363930	340425	23505	6.5
2	2015	Apr	67.2	62.9	363786	340270	23516	6.5
2	2015	May	67.2	62.8	363598	340103	23495	6.5
2	2015	Jun	67.1	62.7	363384	339916	23468	6.5
2	2015	Jul	67	62.7	363167	339696	23471	6.5
2	2015	Aug	66.9	62.6	362957	339431	23526	6.5
2	2015	Sep	66.8	62.5	362746	339113	23633	6.5
2	2015	Oct	66.8	62.4	362542	338763	23779	6.6
2	2015	Nov	66.7	62.3	362386	338440	23946	6.6
2	2015	Dec	66.7	62.2	362323	338198	24125	6.7
2	2016	Jan	66.5	62.1	362326	338026	24300	6.7
2	2016	Feb	66.5	62	362337	337879	24458	6.8
2	2016	Mar	66.5	62	362317	337721	24596	6.8
2	2016	Apr	66.4	61.9	362235	337520	24715	6.8
2	2016	May	66.4	61.8	362074	337261	24813	6.9
2	2016	Jun	66.3	61.7	361847	336972	24875	6.9
2	2016	Jul	66.2	61.6	361613	336707	24906	6.9
2	2016	Aug	66.1	61.6	361426	336495	24931	6.9
2	2016	Sep	66.1	61.5	361330	336361	24969	6.9
2	2016	Oct	66.1	61.5	361322	336309	25013	6.9
2	2016	Nov	66.1	61.5	361337	336280	25057	6.9
2	2016	Dec	66.1	61.5	361295	336208	25087	6.9
2	2017	Jan	66.1	61.5	361184	336091	25093	6.9
2	2017	Feb	66	61.4	360999	335923	25076	6.9
2	2017	Mar	66	61.4	360734	335685	25049	6.9
2	2017	Apr	65.9	61.4	360424	335404	25020	6.9
2	2017	May	65.9	61.3	360108	335115	24993	6.9
2	2017	Jun	65.8	61.2	359773	334812	24961	6.9
2	2017	Jul	65.8	61.2	359397	334477	24920	6.9
2	2017	Aug	65.7	61.1	358955	334099	24856	6.9
2	2017	Sep	65.6	61	358433	333676	24757	6.9
2	2017	Oct	65.5	61	357834	333225	24609	6.9
2	2017	Nov	65.3	60.9	357182	332767	24415	6.8
2	2017	Dec	65.2	60.8	356505	332314	24191	6.8
2	2018	Jan	65.1	60.7	355829	331874	23955	6.7
2	2018	Feb	65	60.7	355178	331455	23723	6.7
2	2018	Mar	64.9	60.6	354566	331070	23496	6.6
2	2018	Apr	64.8	60.6	353961	330684	23277	6.6
2	2018	May	64.7	60.5	353358	330286	23072	6.5
2	2018	Jun	64.6	60.4	352793	329915	22878	6.5
2	2018	Jul	64.5	60.4	352275	329595	22680	6.4
2	2018	Aug	64.4	60.3	351779	329316	22463	6.4
2	2018	Sep	64.4	60.3	351291	329057	22234	6.3
2	2018	Oct	64.3	60.2	350796	328786	22010	6.3
2	2018	Nov	64.2	60.2	350301	328499	21802	6.2
2	2018	Dec	64.1	60.2	349804	328196	21608	6.2
2	2019	Jan	64	60.1	349304	327856	21448	6.1
2	2019	Feb	64	60.1	348849	327502	21347	6.1
2	2019	Mar	63.9	60	348497	327179	21318	6.1
2	2019	Apr	63.9	60	348294	326939	21355	6.1
2	2019	May	63.9	60	348202	326774	21428	6.2
2	2019	Jun	63.9	60	348117	326611	21506	6.2
2	2019	Jul	63.9	59.9	347947	326408	21539	6.2
2	2019	Aug	63.8	59.9	347620	326119	21501	6.2
2	2019	Sep	63.8	59.8	347254	325848	21406	6.2
2	2019	Oct	63.7	59.8	346910	325618	21292	6.1
2	2019	Nov	63.7	59.8	346806	325568	21238	6.1
2	2019	Dec	63.7	59.8	346831	325597	21234	6.1
2	2020	Jan	63.6	59.8	346278	325347	20931	6
2	2020	Feb	63.5	59.8	345422	325325	20097	5.8
4	2010	Jan	62.4	55.6	3114963	2775542	339421	10.9
4	2010	Feb	62.3	55.6	3114578	2777742	336836	10.8
4	2010	Mar	62.2	55.5	3112379	2779363	333016	10.7
4	2010	Apr	64.2	57.4	3107972	2779450	328522	10.6
4	2010	May	64	57.4	3101692	2778096	323596	10.4
4	2010	Jun	63.8	57.2	3094080	2775146	318934	10.3
4	2010	Jul	63.6	57.1	3086291	2770957	315334	10.2
4	2010	Aug	63.3	56.9	3079408	2766497	312911	10.2
4	2010	Sep	63.1	56.7	3073232	2762089	311143	10.1
4	2010	Oct	62.9	56.6	3067756	2758460	309296	10.1
4	2010	Nov	62.7	56.5	3062664	2755692	306972	10
4	2010	Dec	62.6	56.3	3057057	2753511	303546	9.9
4	2011	Jan	62.4	56.2	3051635	2751937	299698	9.8
4	2011	Feb	62.2	56.2	3047219	2750390	296829	9.7
4	2011	Mar	62.1	56	3043638	2748304	295334	9.7
4	2011	Apr	61.9	55.9	3040387	2745380	295007	9.7
4	2011	May	61.8	55.8	3037670	2742239	295431	9.7
4	2011	Jun	61.7	55.7	3035585	2740189	295396	9.7
4	2011	Jul	61.6	55.6	3034074	2740390	293684	9.7
4	2011	Aug	61.5	55.6	3032960	2742980	289980	9.6
4	2011	Sep	61.4	55.6	3032042	2747441	284601	9.4
4	2011	Oct	61.2	55.6	3031234	2752767	278467	9.2
4	2011	Nov	61.1	55.6	3030271	2757700	272571	9
4	2011	Dec	61	55.6	3029294	2761310	267984	8.8
4	2012	Jan	60.9	55.6	3028300	2763459	264841	8.7
4	2012	Feb	60.8	55.6	3027474	2764958	262516	8.7
4	2012	Mar	60.8	55.5	3027314	2766197	261117	8.6
4	2012	Apr	60.7	55.5	3027619	2767531	260088	8.6
4	2012	May	60.6	55.5	3028537	2769954	258583	8.5
4	2012	Jun	60.6	55.5	3029753	2773665	256088	8.5
4	2012	Jul	60.5	55.5	3030883	2778294	252589	8.3
4	2012	Aug	60.4	55.5	3031732	2783077	248655	8.2
4	2012	Sep	60.4	55.5	3032171	2787112	245059	8.1
4	2012	Oct	60.3	55.5	3031497	2789222	242275	8
4	2012	Nov	60.2	55.4	3029541	2788907	240634	7.9
4	2012	Dec	60	55.3	3026754	2786776	239978	7.9
4	2013	Jan	59.9	55.1	3023927	2783920	240007	7.9
4	2013	Feb	59.8	55	3021932	2781860	240072	7.9
4	2013	Mar	59.7	55	3021364	2781934	239430	7.9
4	2013	Apr	59.7	55	3023002	2784799	238203	7.9
4	2013	May	59.7	55	3025925	2788992	236933	7.8
4	2013	Jun	59.6	55	3028952	2792987	235965	7.8
4	2013	Jul	59.6	55	3031474	2796196	235278	7.8
4	2013	Aug	59.5	54.9	3032939	2798714	234225	7.7
4	2013	Sep	59.5	54.9	3033776	2801365	232411	7.7
4	2013	Oct	59.4	54.9	3035645	2805357	230288	7.6
4	2013	Nov	59.4	54.9	3039532	2811745	227787	7.5
4	2013	Dec	59.4	55	3045046	2820238	224808	7.4
4	2014	Jan	59.6	55.3	3061071	2839124	221947	7.3
4	2014	Feb	59.7	55.4	3067752	2849262	218490	7.1
4	2014	Mar	59.7	55.5	3074365	2858757	215608	7
4	2014	Apr	59.7	55.6	3080183	2866830	213353	6.9
4	2014	May	59.8	55.7	3085658	2874193	211465	6.9
4	2014	Jun	59.8	55.7	3092241	2882391	209850	6.8
4	2014	Jul	59.9	55.8	3100204	2891629	208575	6.7
4	2014	Aug	59.9	55.9	3109663	2901898	207765	6.7
4	2014	Sep	60	56	3119950	2912684	207266	6.6
4	2014	Oct	60.1	56.1	3129213	2922866	206347	6.6
4	2014	Nov	60.1	56.2	3136103	2931335	204768	6.5
4	2014	Dec	60.2	56.3	3141171	2938249	202922	6.5
4	2015	Jan	60.1	56.3	3143258	2941919	201339	6.4
4	2015	Feb	60.1	56.3	3146265	2947133	199132	6.3
4	2015	Mar	60.1	56.3	3149585	2952598	196987	6.3
4	2015	Apr	60.1	56.3	3153768	2958757	195011	6.2
4	2015	May	60.1	56.4	3158359	2965010	193349	6.1
4	2015	Jun	60	56.4	3162466	2970438	192028	6.1
4	2015	Jul	60	56.4	3165937	2974937	191000	6
4	2015	Aug	60	56.4	3169022	2979030	189992	6
4	2015	Sep	59.9	56.3	3172263	2983737	188526	5.9
4	2015	Oct	59.9	56.4	3176917	2990409	186508	5.9
4	2015	Nov	59.9	56.4	3183491	2999291	184200	5.8
4	2015	Dec	59.9	56.5	3191279	3009518	181761	5.7
4	2016	Jan	60	56.6	3199470	3019993	179477	5.6
4	2016	Feb	60.1	56.7	3207431	3029724	177707	5.5
4	2016	Mar	60.1	56.8	3214545	3038110	176435	5.5
4	2016	Apr	60.1	56.8	3220718	3045127	175591	5.5
4	2016	May	60.1	56.8	3226583	3051523	175060	5.4
4	2016	Jun	60.1	56.9	3232574	3058027	174547	5.4
4	2016	Jul	60.1	56.9	3238891	3065170	173721	5.4
4	2016	Aug	60.2	57	3245590	3072955	172635	5.3
4	2016	Sep	60.2	57	3252657	3081010	171647	5.3
4	2016	Oct	60.2	57.1	3259740	3088914	170826	5.2
4	2016	Nov	60.2	57.1	3266978	3097002	169976	5.2
4	2016	Dec	60.3	57.2	3274591	3105519	169072	5.2
4	2017	Jan	60.3	57.2	3282429	3114283	168146	5.1
4	2017	Feb	60.4	57.3	3290284	3123321	166963	5.1
4	2017	Mar	60.4	57.4	3297732	3132221	165511	5
4	2017	Apr	60.5	57.5	3305044	3141191	163853	5
4	2017	May	60.5	57.6	3312332	3150385	161947	4.9
4	2017	Jun	60.6	57.6	3319371	3159326	160045	4.8
4	2017	Jul	60.6	57.7	3326257	3167678	158579	4.8
4	2017	Aug	60.6	57.7	3332708	3174978	157730	4.7
4	2017	Sep	60.6	57.7	3338749	3181220	157529	4.7
4	2017	Oct	60.6	57.7	3344829	3186910	157919	4.7
4	2017	Nov	60.6	57.7	3351184	3192358	158826	4.7
4	2017	Dec	60.6	57.7	3358236	3198442	159794	4.8
4	2018	Jan	60.7	57.8	3366486	3205948	160538	4.8
4	2018	Feb	60.8	57.9	3376106	3215169	160937	4.8
4	2018	Mar	60.9	58	3386426	3225595	160831	4.7
4	2018	Apr	60.9	58.1	3396135	3235878	160257	4.7
4	2018	May	61	58.1	3404930	3245296	159634	4.7
4	2018	Jun	61.1	58.2	3413715	3254394	159321	4.7
4	2018	Jul	61.1	58.3	3423234	3263708	159526	4.7
4	2018	Aug	61.2	58.3	3434389	3273765	160624	4.7
4	2018	Sep	61.3	58.4	3447202	3284637	162565	4.7
4	2018	Oct	61.4	58.5	3460835	3295879	164956	4.8
4	2018	Nov	61.6	58.6	3474104	3306870	167234	4.8
4	2018	Dec	61.7	58.7	3485584	3316612	168972	4.8
4	2019	Jan	61.7	58.7	3494658	3324691	169967	4.9
4	2019	Feb	61.8	58.8	3501692	3331523	170169	4.9
4	2019	Mar	61.8	58.8	3508284	3338340	169944	4.8
4	2019	Apr	61.8	58.8	3516267	3346809	169458	4.8
4	2019	May	61.9	58.9	3526522	3357716	168806	4.8
4	2019	Jun	62	59.1	3539197	3371074	168123	4.8
4	2019	Jul	62.2	59.3	3555243	3388011	167232	4.7
4	2019	Aug	62.4	59.5	3571555	3405655	165900	4.6
4	2019	Sep	62.5	59.6	3585858	3421432	164426	4.6
4	2019	Oct	62.5	59.7	3595710	3432393	163317	4.5
4	2019	Nov	62.5	59.6	3596303	3433191	163112	4.5
4	2019	Dec	62.3	59.5	3594630	3431327	163303	4.5
4	2020	Jan	62.4	59.6	3604805	3442732	162073	4.5
4	2020	Feb	62.4	59.6	3613058	3451762	161296	4.5
5	2010	Jan	60.8	55.8	1344729	1234457	110272	8.2
5	2010	Feb	60.7	55.8	1345101	1234769	110332	8.2
5	2010	Mar	60.8	55.8	1346699	1236603	110096	8.2
5	2010	Apr	60.5	55.5	1349305	1239491	109814	8.1
5	2010	May	60.6	55.6	1352246	1242672	109574	8.1
5	2010	Jun	60.6	55.7	1354708	1245193	109515	8.1
5	2010	Jul	60.6	55.7	1356281	1246536	109745	8.1
5	2010	Aug	60.6	55.7	1357229	1246897	110332	8.1
5	2010	Sep	60.6	55.6	1357956	1246675	111281	8.2
5	2010	Oct	60.6	55.6	1358740	1246341	112399	8.3
5	2010	Nov	60.6	55.5	1359844	1246324	113520	8.3
5	2010	Dec	60.6	55.5	1361151	1246683	114468	8.4
5	2011	Jan	60.6	55.5	1362117	1246936	115181	8.5
5	2011	Feb	60.6	55.5	1362339	1246677	115662	8.5
5	2011	Mar	60.5	55.4	1361797	1245986	115811	8.5
5	2011	Apr	60.5	55.3	1360729	1245118	115611	8.5
5	2011	May	60.4	55.3	1359781	1244596	115185	8.5
5	2011	Jun	60.3	55.2	1359520	1244978	114542	8.4
5	2011	Jul	60.3	55.3	1360317	1246599	113718	8.4
5	2011	Aug	60.4	55.4	1361993	1249276	112717	8.3
5	2011	Sep	60.4	55.5	1363951	1252523	111428	8.2
5	2011	Oct	60.5	55.6	1365660	1255728	109932	8
5	2011	Nov	60.5	55.7	1366313	1258015	108298	7.9
5	2011	Dec	60.4	55.7	1365422	1258774	106648	7.8
5	2012	Jan	60.3	55.6	1363322	1258194	105128	7.7
5	2012	Feb	60.1	55.5	1360430	1256572	103858	7.6
5	2012	Mar	60	55.4	1357024	1254064	102960	7.6
5	2012	Apr	59.8	55.3	1353406	1250988	102418	7.6
5	2012	May	59.6	55.1	1349774	1247651	102123	7.6
5	2012	Jun	59.4	54.9	1345970	1244049	101921	7.6
5	2012	Jul	59.2	54.7	1341588	1239998	101590	7.6
5	2012	Aug	58.9	54.5	1336800	1235720	101080	7.6
5	2012	Sep	58.7	54.3	1332413	1231885	100528	7.5
5	2012	Oct	58.5	54.1	1328909	1228964	99945	7.5
5	2012	Nov	58.4	54	1326628	1227266	99362	7.5
5	2012	Dec	58.4	54	1325703	1226880	98823	7.5
5	2013	Jan	58.3	54	1325721	1227306	98415	7.4
5	2013	Feb	58.4	54	1326140	1227981	98159	7.4
5	2013	Mar	58.4	54	1326434	1228455	97979	7.4
5	2013	Apr	58.3	54	1326202	1228419	97783	7.4
5	2013	May	58.3	54	1325281	1227772	97509	7.4
5	2013	Jun	58.2	53.9	1324000	1226874	97126	7.3
5	2013	Jul	58.1	53.9	1322766	1226174	96592	7.3
5	2013	Aug	58	53.8	1321408	1225720	95688	7.2
5	2013	Sep	57.9	53.8	1319612	1225301	94311	7.1
5	2013	Oct	57.8	53.7	1317651	1224973	92678	7
5	2013	Nov	57.7	53.7	1315812	1224887	90925	6.9
5	2013	Dec	57.6	53.7	1314233	1225176	89057	6.8
5	2014	Jan	57.6	53.7	1313361	1226351	87010	6.6
5	2014	Feb	57.5	53.8	1312912	1227953	84959	6.5
5	2014	Mar	57.5	53.9	1312795	1229772	83023	6.3
5	2014	Apr	57.5	53.9	1312909	1231554	81355	6.2
5	2014	May	57.5	54	1313181	1233243	79938	6.1
5	2014	Jun	57.5	54	1313710	1234973	78737	6
5	2014	Jul	57.5	54.1	1314665	1236927	77738	5.9
5	2014	Aug	57.5	54.2	1316300	1239340	76960	5.8
5	2014	Sep	57.6	54.3	1318569	1242232	76337	5.8
5	2014	Oct	57.7	54.4	1321016	1245304	75712	5.7
5	2014	Nov	57.8	54.5	1323148	1248056	75092	5.7
5	2014	Dec	57.8	54.5	1324880	1250267	74613	5.6
5	2015	Jan	57.8	54.6	1326036	1252085	73951	5.6
5	2015	Feb	57.9	54.7	1327114	1253507	73607	5.5
5	2015	Mar	57.9	54.7	1328132	1255129	73003	5.5
5	2015	Apr	57.9	54.8	1329207	1257263	71944	5.4
5	2015	May	57.9	54.9	1330320	1259919	70401	5.3
5	2015	Jun	58	55	1331306	1262825	68481	5.1
5	2015	Jul	58	55.1	1332142	1265765	66377	5
5	2015	Aug	58	55.2	1332836	1268549	64287	4.8
5	2015	Sep	58	55.3	1333420	1271086	62334	4.7
5	2015	Oct	58	55.3	1334177	1273561	60616	4.5
5	2015	Nov	58	55.4	1335284	1276163	59121	4.4
5	2015	Dec	58	55.5	1336483	1278705	57778	4.3
5	2016	Jan	58	55.6	1337486	1280917	56569	4.2
5	2016	Feb	58	55.6	1338202	1282661	55541	4.2
5	2016	Mar	58	55.7	1338608	1283913	54695	4.1
5	2016	Apr	58	55.7	1338900	1284824	54076	4
5	2016	May	58	55.7	1339336	1285666	53670	4
5	2016	Jun	58	55.7	1339929	1286579	53350	4
5	2016	Jul	58	55.7	1340483	1287491	52992	4
5	2016	Aug	58	55.7	1340822	1288257	52565	3.9
5	2016	Sep	58	55.7	1340911	1288824	52087	3.9
5	2016	Oct	57.9	55.7	1340679	1289185	51494	3.8
5	2016	Nov	57.9	55.7	1340333	1289558	50775	3.8
5	2016	Dec	57.9	55.7	1340253	1290214	50039	3.7
5	2017	Jan	57.9	55.7	1340760	1291336	49424	3.7
5	2017	Feb	57.9	55.8	1341916	1292907	49009	3.7
5	2017	Mar	57.9	55.8	1343493	1294611	48882	3.6
5	2017	Apr	58	55.9	1345229	1296194	49035	3.6
5	2017	May	58	55.9	1346838	1297486	49352	3.7
5	2017	Jun	58.1	55.9	1348160	1298417	49743	3.7
5	2017	Jul	58.1	55.9	1349144	1299024	50120	3.7
5	2017	Aug	58.1	55.9	1349708	1299345	50363	3.7
5	2017	Sep	58.1	55.9	1349858	1299427	50431	3.7
5	2017	Oct	58	55.9	1349769	1299370	50399	3.7
5	2017	Nov	58	55.8	1349591	1299197	50394	3.7
5	2017	Dec	58	55.8	1349478	1299051	50427	3.7
5	2018	Jan	58	55.8	1349555	1299054	50501	3.7
5	2018	Feb	58	55.8	1349868	1299305	50563	3.7
5	2018	Mar	58	55.8	1350386	1299917	50469	3.7
5	2018	Apr	58	55.8	1350866	1300745	50121	3.7
5	2018	May	58	55.8	1351212	1301603	49609	3.7
5	2018	Jun	58	55.9	1351596	1302534	49062	3.6
5	2018	Jul	58	55.9	1352169	1303583	48586	3.6
5	2018	Aug	58	55.9	1353228	1304892	48336	3.6
5	2018	Sep	58	55.9	1354940	1306573	48367	3.6
5	2018	Oct	58.1	56	1357108	1308521	48587	3.6
5	2018	Nov	58.2	56.1	1359350	1310531	48819	3.6
5	2018	Dec	58.2	56.1	1361225	1312311	48914	3.6
5	2019	Jan	58.3	56.2	1362313	1313527	48786	3.6
5	2019	Feb	58.2	56.2	1362467	1313963	48504	3.6
5	2019	Mar	58.2	56.1	1361942	1313673	48269	3.5
5	2019	Apr	58.2	56.1	1361142	1312967	48175	3.5
5	2019	May	58.1	56	1360506	1312287	48219	3.5
5	2019	Jun	58.1	56	1360371	1312004	48367	3.6
5	2019	Jul	58.1	56	1361041	1312512	48529	3.6
5	2019	Aug	58.1	56	1362055	1313485	48570	3.6
5	2019	Sep	58.1	56.1	1363257	1314807	48450	3.6
5	2019	Oct	58.1	56.1	1364178	1315900	48278	3.5
5	2019	Nov	58.1	56.1	1364331	1316141	48190	3.5
5	2019	Dec	58.1	56	1364255	1316069	48186	3.5
5	2020	Jan	58.2	56.1	1366308	1318240	48068	3.5
5	2020	Feb	58.2	56.2	1367278	1319479	47799	3.5
6	2010	Jan	64.7	56.8	18214520	15997913	2216607	12.2
6	2010	Feb	64.8	56.9	18262083	16028580	2233503	12.2
6	2010	Mar	64.9	57	18304098	16061366	2242732	12.3
6	2010	Apr	64.2	56.4	18335653	16090440	2245213	12.2
6	2010	May	64.3	56.4	18353688	16112833	2240855	12.2
6	2010	Jun	64.2	56.4	18358525	16124135	2234390	12.2
6	2010	Jul	64.1	56.3	18356993	16123990	2233003	12.2
6	2010	Aug	64.1	56.3	18356485	16117692	2238793	12.2
6	2010	Sep	64	56.2	18358124	16110216	2247908	12.2
6	2010	Oct	63.9	56.1	18362121	16108305	2253816	12.3
6	2010	Nov	63.9	56.1	18365212	16114079	2251133	12.3
6	2010	Dec	63.8	56	18364493	16125892	2238601	12.2
6	2011	Jan	63.7	56	18363014	16142515	2220499	12.1
6	2011	Feb	63.7	56.1	18362012	16160153	2201859	12
6	2011	Mar	63.6	56.1	18360392	16174823	2185569	11.9
6	2011	Apr	63.6	56	18360297	16185015	2175282	11.8
6	2011	May	63.5	56	18367442	16194332	2173110	11.8
6	2011	Jun	63.5	56	18383605	16209240	2174365	11.8
6	2011	Jul	63.5	56	18407886	16235500	2172386	11.8
6	2011	Aug	63.6	56.1	18436089	16272656	2163433	11.7
6	2011	Sep	63.6	56.2	18461927	16316061	2145866	11.6
6	2011	Oct	63.6	56.3	18481109	16359672	2121437	11.5
6	2011	Nov	63.6	56.4	18489447	16396794	2092653	11.3
6	2011	Dec	63.5	56.4	18486653	16423914	2062739	11.2
6	2012	Jan	63.4	56.4	18478244	16442867	2035377	11
6	2012	Feb	63.3	56.4	18472694	16459497	2013197	10.9
6	2012	Mar	63.3	56.4	18474388	16476663	1997725	10.8
6	2012	Apr	63.2	56.4	18480818	16496074	1984744	10.7
6	2012	May	63.2	56.5	18491774	16522575	1969199	10.6
6	2012	Jun	63.2	56.5	18506306	16558495	1947811	10.5
6	2012	Jul	63.2	56.6	18522031	16602505	1919526	10.4
6	2012	Aug	63.2	56.7	18540096	16651465	1888631	10.2
6	2012	Sep	63.2	56.9	18563262	16702042	1861220	10
6	2012	Oct	63.2	57	18586398	16748317	1838081	9.9
6	2012	Nov	63.2	57	18605146	16786723	1818423	9.8
6	2012	Dec	63.2	57.1	18616736	16817255	1799481	9.7
6	2013	Jan	63.1	57.1	18615393	16835906	1779487	9.6
6	2013	Feb	63.1	57.1	18614456	16856557	1757899	9.4
6	2013	Mar	63	57.1	18614695	16880238	1734457	9.3
6	2013	Apr	63	57.2	18622241	16910983	1711258	9.2
6	2013	May	63	57.3	18634480	16942752	1691728	9.1
6	2013	Jun	63	57.3	18645876	16968882	1676994	9
6	2013	Jul	62.9	57.3	18652081	16987525	1664556	8.9
6	2013	Aug	62.8	57.3	18647231	17000090	1647141	8.8
6	2013	Sep	62.7	57.3	18632088	17010624	1621464	8.7
6	2013	Oct	62.6	57.2	18617976	17024977	1592999	8.6
6	2013	Nov	62.5	57.3	18614669	17048438	1566231	8.4
6	2013	Dec	62.5	57.3	18623953	17081350	1542603	8.3
6	2014	Jan	62.4	57.3	18603550	17086089	1517461	8.2
6	2014	Feb	62.4	57.4	18625521	17131337	1494184	8
6	2014	Mar	62.4	57.5	18646753	17175024	1471729	7.9
6	2014	Apr	62.4	57.6	18663311	17212512	1450799	7.8
6	2014	May	62.4	57.6	18676518	17246970	1429548	7.7
6	2014	Jun	62.4	57.7	18693090	17284748	1408342	7.5
6	2014	Jul	62.4	57.8	18714593	17325669	1388924	7.4
6	2014	Aug	62.4	57.9	18742319	17369725	1372594	7.3
6	2014	Sep	62.5	58	18773334	17415533	1357801	7.2
6	2014	Oct	62.5	58	18799130	17459211	1339919	7.1
6	2014	Nov	62.5	58.1	18813677	17496448	1317229	7
6	2014	Dec	62.5	58.2	18821145	17527359	1293786	6.9
6	2015	Jan	62.3	58.1	18805090	17534265	1270825	6.8
6	2015	Feb	62.3	58.2	18810534	17557274	1253260	6.7
6	2015	Mar	62.3	58.2	18818567	17581698	1236869	6.6
6	2015	Apr	62.3	58.2	18827074	17608247	1218827	6.5
6	2015	May	62.2	58.3	18831346	17633523	1197823	6.4
6	2015	Jun	62.2	58.3	18827709	17653880	1173829	6.2
6	2015	Jul	62.1	58.3	18820107	17670644	1149463	6.1
6	2015	Aug	62	58.3	18814621	17686845	1127776	6
6	2015	Sep	62	58.3	18815869	17706715	1109154	5.9
6	2015	Oct	62	58.4	18830096	17735420	1094676	5.8
6	2015	Nov	62	58.4	18858558	17773316	1085242	5.8
6	2015	Dec	62.1	58.5	18893485	17815446	1078039	5.7
6	2016	Jan	62.1	58.6	18926070	17855481	1070589	5.7
6	2016	Feb	62.2	58.7	18952145	17888925	1063220	5.6
6	2016	Mar	62.2	58.7	18970327	17914453	1055874	5.6
6	2016	Apr	62.2	58.7	18984487	17934428	1050059	5.5
6	2016	May	62.2	58.8	19000500	17953279	1047221	5.5
6	2016	Jun	62.2	58.8	19019232	17973079	1046153	5.5
6	2016	Jul	62.2	58.8	19038379	17994046	1044333	5.5
6	2016	Aug	62.2	58.8	19055895	18014599	1041296	5.5
6	2016	Sep	62.2	58.8	19070713	18032659	1038054	5.4
6	2016	Oct	62.2	58.8	19080636	18047896	1032740	5.4
6	2016	Nov	62.2	58.9	19087209	18064320	1022889	5.4
6	2016	Dec	62.2	58.9	19094492	18085431	1009061	5.3
6	2017	Jan	62.2	58.9	19105316	18112068	993248	5.2
6	2017	Feb	62.2	59	19119415	18143174	976241	5.1
6	2017	Mar	62.2	59.1	19134439	18173987	960452	5
6	2017	Apr	62.2	59.1	19150981	18203726	947255	4.9
6	2017	May	62.2	59.2	19168420	18232933	935487	4.9
6	2017	Jun	62.3	59.3	19185241	18260479	924762	4.8
6	2017	Jul	62.3	59.3	19200581	18285677	914904	4.8
6	2017	Aug	62.3	59.3	19210386	18306843	903543	4.7
6	2017	Sep	62.3	59.4	19213079	18323455	889624	4.6
6	2017	Oct	62.2	59.4	19210520	18336244	874276	4.6
6	2017	Nov	62.2	59.4	19204927	18344984	859943	4.5
6	2017	Dec	62.1	59.4	19200661	18353112	847549	4.4
6	2018	Jan	62.1	59.4	19203648	18364857	838791	4.4
6	2018	Feb	62.1	59.4	19217455	18383340	834115	4.3
6	2018	Mar	62.2	59.5	19238651	18407492	831159	4.3
6	2018	Apr	62.2	59.5	19257356	18430112	827244	4.3
6	2018	May	62.2	59.6	19268241	18446042	822199	4.3
6	2018	Jun	62.2	59.6	19273397	18457360	816037	4.2
6	2018	Jul	62.2	59.6	19276424	18467125	809299	4.2
6	2018	Aug	62.2	59.6	19284439	18478793	805646	4.2
6	2018	Sep	62.2	59.6	19301370	18494446	806924	4.2
6	2018	Oct	62.3	59.7	19326217	18513320	812897	4.2
6	2018	Nov	62.4	59.7	19353831	18532420	821411	4.2
6	2018	Dec	62.4	59.7	19375276	18546310	828966	4.3
6	2019	Jan	62.4	59.7	19382859	18550985	831874	4.3
6	2019	Feb	62.4	59.7	19374147	18546169	827978	4.3
6	2019	Mar	62.3	59.7	19356775	18537826	818949	4.2
6	2019	Apr	62.2	59.6	19342084	18535623	806461	4.2
6	2019	May	62.2	59.7	19338261	18545462	792799	4.1
6	2019	Jun	62.2	59.7	19349894	18568928	780966	4
6	2019	Jul	62.3	59.8	19380953	18609341	771612	4
6	2019	Aug	62.4	59.9	19419719	18655883	763836	3.9
6	2019	Sep	62.5	60.1	19458303	18700422	757881	3.9
6	2019	Oct	62.6	60.1	19485335	18731357	753978	3.9
6	2019	Nov	62.5	60.1	19487634	18733893	753741	3.9
6	2019	Dec	62.5	60.1	19483790	18729074	754716	3.9
6	2020	Jan	62.6	60.2	19509644	18756375	753269	3.9
6	2020	Feb	62.6	60.1	19515998	18756884	759114	3.9
8	2010	Jan	70.1	64.3	2714266	2488218	226048	8.3
8	2010	Feb	70.1	64.2	2718865	2488580	230285	8.5
8	2010	Mar	70.2	64.1	2722791	2489213	233578	8.6
8	2010	Apr	70.8	64.7	2725446	2489593	235853	8.7
8	2010	May	70.8	64.6	2726694	2489552	237142	8.7
8	2010	Jun	70.7	64.5	2726542	2488575	237967	8.7
8	2010	Jul	70.6	64.4	2725775	2486711	239064	8.8
8	2010	Aug	70.5	64.3	2725309	2484727	240582	8.8
8	2010	Sep	70.4	64.1	2725176	2483000	242176	8.9
8	2010	Oct	70.3	64	2725408	2482187	243221	8.9
8	2010	Nov	70.2	63.9	2725575	2482569	243006	8.9
8	2010	Dec	70.1	63.9	2725739	2484035	241704	8.9
8	2011	Jan	70	63.8	2726142	2486606	239536	8.8
8	2011	Feb	69.9	63.8	2726295	2489803	236492	8.7
8	2011	Mar	69.8	63.8	2725870	2492959	232911	8.5
8	2011	Apr	69.7	63.8	2725243	2495652	229591	8.4
8	2011	May	69.6	63.8	2725485	2498260	227225	8.3
8	2011	Jun	69.6	63.8	2727538	2501595	225943	8.3
8	2011	Jul	69.6	63.8	2731838	2506281	225557	8.3
8	2011	Aug	69.6	63.9	2737851	2512064	225787	8.2
8	2011	Sep	69.7	63.9	2744437	2518200	226237	8.2
8	2011	Oct	69.7	64	2750277	2523717	226560	8.2
8	2011	Nov	69.7	64	2754113	2527589	226524	8.2
8	2011	Dec	69.6	63.9	2755211	2529433	225778	8.2
8	2012	Jan	69.5	63.8	2754132	2529588	224544	8.2
8	2012	Feb	69.4	63.7	2752543	2529062	223481	8.1
8	2012	Mar	69.3	63.7	2751340	2528560	222780	8.1
8	2012	Apr	69.2	63.6	2750712	2528512	222200	8.1
8	2012	May	69.1	63.5	2751221	2529773	221448	8
8	2012	Jun	69	63.5	2753000	2532746	220254	8
8	2012	Jul	69	63.5	2755737	2537362	218375	7.9
8	2012	Aug	69	63.6	2759167	2543095	216072	7.8
8	2012	Sep	68.9	63.6	2763026	2549191	213835	7.7
8	2012	Oct	68.9	63.6	2766298	2554638	211660	7.7
8	2012	Nov	68.9	63.6	2768164	2558745	209419	7.6
8	2012	Dec	68.8	63.6	2768370	2561350	207020	7.5
8	2013	Jan	68.6	63.6	2767274	2562697	204577	7.4
8	2013	Feb	68.5	63.5	2765868	2563642	202226	7.3
8	2013	Mar	68.4	63.5	2765227	2565296	199931	7.2
8	2013	Apr	68.3	63.5	2766087	2568489	197598	7.1
8	2013	May	68.3	63.5	2767770	2572419	195351	7.1
8	2013	Jun	68.2	63.5	2769223	2576118	193105	7
8	2013	Jul	68.1	63.4	2769763	2579207	190556	6.9
8	2013	Aug	68	63.4	2769026	2581863	187163	6.8
8	2013	Sep	67.8	63.4	2767659	2584827	182832	6.6
8	2013	Oct	67.7	63.4	2767060	2588943	178117	6.4
8	2013	Nov	67.7	63.4	2768743	2595010	173733	6.3
8	2013	Dec	67.7	63.5	2772991	2603132	169859	6.1
8	2014	Jan	67.8	63.7	2781177	2615291	165886	6
8	2014	Feb	67.8	63.9	2787334	2625732	161602	5.8
8	2014	Mar	67.9	64	2792856	2636069	156787	5.6
8	2014	Apr	67.9	64.2	2796938	2645435	151503	5.4
8	2014	May	67.8	64.3	2799663	2653932	145731	5.2
8	2014	Jun	67.8	64.4	2801950	2662096	139854	5
8	2014	Jul	67.7	64.5	2804294	2669823	134471	4.8
8	2014	Aug	67.6	64.5	2807159	2677061	130098	4.6
8	2014	Sep	67.6	64.5	2810417	2683613	126804	4.5
8	2014	Oct	67.5	64.5	2813456	2689100	124356	4.4
8	2014	Nov	67.4	64.5	2815523	2693174	122349	4.3
8	2014	Dec	67.4	64.5	2816915	2696168	120747	4.3
8	2015	Jan	67.2	64.3	2815134	2694755	120379	4.3
8	2015	Feb	67.1	64.3	2816684	2697100	119584	4.2
8	2015	Mar	67	64.2	2818498	2699990	118508	4.2
8	2015	Apr	67	64.2	2820390	2703597	116793	4.1
8	2015	May	66.9	64.2	2821938	2707500	114438	4.1
8	2015	Jun	66.8	64.1	2822707	2711141	111566	4
8	2015	Jul	66.7	64.1	2823123	2714574	108549	3.8
8	2015	Aug	66.6	64.1	2824036	2718319	105717	3.7
8	2015	Sep	66.5	64.1	2826310	2723153	103157	3.6
8	2015	Oct	66.5	64.1	2830882	2729813	101069	3.6
8	2015	Nov	66.5	64.2	2837974	2738262	99712	3.5
8	2015	Dec	66.6	64.3	2846562	2747516	99046	3.5
8	2016	Jan	66.7	64.4	2855252	2756418	98834	3.5
8	2016	Feb	66.8	64.5	2863147	2764171	98976	3.5
8	2016	Mar	66.8	64.5	2869786	2770611	99175	3.5
8	2016	Apr	66.8	64.5	2875505	2776260	99245	3.5
8	2016	May	66.9	64.6	2881161	2782143	99018	3.4
8	2016	Jun	66.9	64.6	2887327	2789101	98226	3.4
8	2016	Jul	66.9	64.7	2894043	2797416	96627	3.3
8	2016	Aug	67	64.8	2901038	2806630	94408	3.3
8	2016	Sep	67.1	64.9	2908063	2816018	92045	3.2
8	2016	Oct	67.1	65	2914759	2825162	89597	3.1
8	2016	Nov	67.2	65.2	2921204	2834285	86919	3
8	2016	Dec	67.2	65.3	2927937	2843705	84232	2.9
8	2017	Jan	67.3	65.4	2935360	2853461	81899	2.8
8	2017	Feb	67.4	65.6	2943654	2863479	80175	2.7
8	2017	Mar	67.5	65.7	2952715	2873408	79307	2.7
8	2017	Apr	67.7	65.9	2962529	2883199	79330	2.7
8	2017	May	67.8	66	2972877	2892795	80082	2.7
8	2017	Jun	68	66.1	2983375	2901893	81482	2.7
8	2017	Jul	68.1	66.2	2993700	2910350	83350	2.8
8	2017	Aug	68.2	66.3	3003207	2918071	85136	2.8
8	2017	Sep	68.3	66.3	3011552	2925074	86478	2.9
8	2017	Oct	68.3	66.4	3018886	2931437	87449	2.9
8	2017	Nov	68.4	66.4	3025601	2937284	88317	2.9
8	2017	Dec	68.5	66.4	3032321	2943243	89078	2.9
8	2018	Jan	68.5	66.5	3039756	2949910	89846	3
8	2018	Feb	68.6	66.6	3048319	2957429	90890	3
8	2018	Mar	68.7	66.7	3057607	2965268	92339	3
8	2018	Apr	68.8	66.7	3066430	2972306	94124	3.1
8	2018	May	68.9	66.8	3073935	2977908	96027	3.1
8	2018	Jun	68.9	66.8	3080217	2982461	97756	3.2
8	2018	Jul	69	66.7	3085673	2986530	99143	3.2
8	2018	Aug	69	66.7	3091101	2990761	100340	3.2
8	2018	Sep	69	66.8	3096967	2995718	101249	3.3
8	2018	Oct	69	66.8	3103165	3001544	101621	3.3
8	2018	Nov	69.1	66.8	3109154	3007826	101328	3.3
8	2018	Dec	69.1	66.9	3114211	3013869	100342	3.2
8	2019	Jan	69.1	66.9	3118005	3019332	98673	3.2
8	2019	Feb	69.1	66.9	3120717	3024409	96308	3.1
8	2019	Mar	69.1	67	3123383	3029822	93561	3
8	2019	Apr	69	67	3127272	3036474	90798	2.9
8	2019	May	69.1	67.1	3133013	3044663	88350	2.8
8	2019	Jun	69.2	67.3	3140510	3054147	86363	2.7
8	2019	Jul	69.3	67.4	3150271	3065701	84570	2.7
8	2019	Aug	69.4	67.6	3160179	3077345	82834	2.6
8	2019	Sep	69.5	67.7	3168978	3087657	81321	2.6
8	2019	Oct	69.5	67.8	3175067	3094826	80241	2.5
8	2019	Nov	69.4	67.7	3175472	3095329	80143	2.5
8	2019	Dec	69.3	67.6	3174504	3094165	80339	2.5
8	2020	Jan	69.4	67.6	3180821	3101414	79407	2.5
8	2020	Feb	69.4	67.7	3186421	3106125	80296	2.5
9	2010	Jan	68.8	62.6	1896872	1726968	169904	9
9	2010	Feb	68.9	62.6	1899771	1728256	171515	9
9	2010	Mar	69	62.7	1903190	1730684	172506	9.1
9	2010	Apr	68	61.9	1906859	1733838	173021	9.1
9	2010	May	68.1	61.9	1910490	1737260	173230	9.1
9	2010	Jun	68.2	62	1913669	1740215	173454	9.1
9	2010	Jul	68.2	62	1916044	1742076	173968	9.1
9	2010	Aug	68.2	62	1917663	1742854	174809	9.1
9	2010	Sep	68.2	61.9	1918752	1742905	175847	9.2
9	2010	Oct	68.2	61.9	1919693	1742799	176894	9.2
9	2010	Nov	68.2	61.9	1920583	1742922	177661	9.3
9	2010	Dec	68.2	61.8	1921281	1743364	177917	9.3
9	2011	Jan	68.1	61.8	1921839	1744160	177679	9.2
9	2011	Feb	68.1	61.8	1921980	1744996	176984	9.2
9	2011	Mar	68.1	61.8	1921262	1745441	175821	9.2
9	2011	Apr	68	61.8	1919579	1745305	174274	9.1
9	2011	May	67.8	61.7	1917323	1744842	172481	9
9	2011	Jun	67.7	61.7	1915006	1744519	170487	8.9
9	2011	Jul	67.6	61.7	1913148	1744791	168357	8.8
9	2011	Aug	67.5	61.7	1911831	1745675	166156	8.7
9	2011	Sep	67.4	61.7	1910755	1746903	163852	8.6
9	2011	Oct	67.4	61.7	1909728	1748159	161569	8.5
9	2011	Nov	67.3	61.7	1908451	1748916	159535	8.4
9	2011	Dec	67.2	61.6	1906593	1748647	157946	8.3
9	2012	Jan	67.1	61.6	1904057	1747131	156926	8.2
9	2012	Feb	67	61.4	1901053	1744475	156578	8.2
9	2012	Mar	66.8	61.3	1897790	1740795	156995	8.3
9	2012	Apr	66.7	61.1	1894278	1736266	158012	8.3
9	2012	May	66.5	60.9	1890828	1731589	159239	8.4
9	2012	Jun	66.4	60.7	1887726	1727535	160191	8.5
9	2012	Jul	66.2	60.6	1885184	1724752	160432	8.5
9	2012	Aug	66.1	60.5	1883167	1723301	159866	8.5
9	2012	Sep	66.1	60.5	1881296	1722549	158747	8.4
9	2012	Oct	65.9	60.4	1878778	1721522	157256	8.4
9	2012	Nov	65.8	60.3	1875155	1719640	155515	8.3
9	2012	Dec	65.6	60.2	1870703	1716939	153764	8.2
9	2013	Jan	65.4	60.1	1866104	1713860	152244	8.2
9	2013	Feb	65.3	60	1862393	1711389	151004	8.1
9	2013	Mar	65.2	60	1860344	1710431	149913	8.1
9	2013	Apr	65.2	60	1860317	1711456	148861	8
9	2013	May	65.2	60	1861705	1713811	147894	7.9
9	2013	Jun	65.3	60.1	1863418	1716463	146955	7.9
9	2013	Jul	65.3	60.2	1864609	1718658	145951	7.8
9	2013	Aug	65.3	60.2	1864989	1720349	144640	7.8
9	2013	Sep	65.2	60.2	1865002	1722150	142852	7.7
9	2013	Oct	65.2	60.3	1865500	1724658	140842	7.5
9	2013	Nov	65.3	60.4	1867073	1728285	138788	7.4
9	2013	Dec	65.3	60.6	1869727	1733041	136686	7.3
9	2014	Jan	65.3	60.7	1870139	1736172	133967	7.2
9	2014	Feb	65.4	60.8	1873306	1741488	131818	7
9	2014	Mar	65.5	61	1876503	1746729	129774	6.9
9	2014	Apr	65.6	61.2	1879504	1751638	127866	6.8
9	2014	May	65.7	61.3	1882429	1756345	126084	6.7
9	2014	Jun	65.8	61.4	1885754	1761165	124589	6.6
9	2014	Jul	65.9	61.6	1889431	1765985	123446	6.5
9	2014	Aug	66	61.7	1893216	1770665	122551	6.5
9	2014	Sep	66.1	61.9	1896814	1775082	121732	6.4
9	2014	Oct	66.2	62	1899772	1779108	120664	6.4
9	2014	Nov	66.3	62.1	1901754	1782489	119265	6.3
9	2014	Dec	66.3	62.2	1902795	1785104	117691	6.2
9	2015	Jan	66.3	62.3	1902592	1786748	115844	6.1
9	2015	Feb	66.3	62.3	1901733	1787720	114013	6
9	2015	Mar	66.2	62.3	1899832	1787695	112137	5.9
9	2015	Apr	66.1	62.3	1896966	1786668	110298	5.8
9	2015	May	66	62.2	1893306	1784745	108561	5.7
9	2015	Jun	65.8	62.1	1889106	1782120	106986	5.7
9	2015	Jul	65.7	62	1885082	1779287	105795	5.6
9	2015	Aug	65.5	61.9	1881888	1776763	105125	5.6
9	2015	Sep	65.5	61.8	1879744	1774936	104808	5.6
9	2015	Oct	65.4	61.8	1878867	1774216	104651	5.6
9	2015	Nov	65.4	61.8	1879195	1774740	104455	5.6
9	2015	Dec	65.5	61.8	1880209	1776264	103945	5.5
9	2016	Jan	65.5	61.9	1881587	1778448	103139	5.5
9	2016	Feb	65.6	62	1883269	1781074	102195	5.4
9	2016	Mar	65.6	62.1	1885281	1784062	101219	5.4
9	2016	Apr	65.7	62.2	1887611	1787256	100355	5.3
9	2016	May	65.8	62.3	1890173	1790551	99622	5.3
9	2016	Jun	65.9	62.4	1892592	1793792	98800	5.2
9	2016	Jul	65.9	62.5	1894467	1796841	97626	5.2
9	2016	Aug	66	62.6	1895782	1799624	96158	5.1
9	2016	Sep	66	62.7	1896838	1802158	94680	5
9	2016	Oct	66	62.8	1897845	1804511	93334	4.9
9	2016	Nov	66.1	62.8	1899217	1806906	92311	4.9
9	2016	Dec	66.1	62.9	1901230	1809412	91818	4.8
9	2017	Jan	66.2	63	1903526	1811745	91781	4.8
9	2017	Feb	66.3	63.1	1905362	1813502	91860	4.8
9	2017	Mar	66.3	63.1	1905939	1814156	91783	4.8
9	2017	Apr	66.2	63.1	1905002	1813667	91335	4.8
9	2017	May	66.2	63	1902767	1812276	90491	4.8
9	2017	Jun	66	62.9	1899739	1810231	89508	4.7
9	2017	Jul	65.9	62.8	1896542	1807896	88646	4.7
9	2017	Aug	65.8	62.7	1893535	1805569	87966	4.6
9	2017	Sep	65.7	62.7	1891058	1803573	87485	4.6
9	2017	Oct	65.6	62.6	1889371	1802204	87167	4.6
9	2017	Nov	65.6	62.6	1888351	1801515	86836	4.6
9	2017	Dec	65.6	62.6	1887951	1801694	86257	4.6
9	2018	Jan	65.6	62.6	1888333	1802920	85413	4.5
9	2018	Feb	65.6	62.7	1889624	1805271	84353	4.5
9	2018	Mar	65.7	62.8	1891731	1808623	83108	4.4
9	2018	Apr	65.7	62.9	1894234	1812494	81740	4.3
9	2018	May	65.8	63	1896821	1816459	80362	4.2
9	2018	Jun	65.9	63.2	1899539	1820549	78990	4.2
9	2018	Jul	66	63.3	1902384	1824743	77641	4.1
9	2018	Aug	66.1	63.4	1905267	1828804	76463	4
9	2018	Sep	66.2	63.5	1907801	1832288	75513	4
9	2018	Oct	66.2	63.6	1909496	1834684	74812	3.9
9	2018	Nov	66.2	63.7	1909960	1835758	74202	3.9
9	2018	Dec	66.2	63.6	1908987	1835491	73496	3.9
9	2019	Jan	66.1	63.6	1906788	1834176	72612	3.8
9	2019	Feb	66	63.6	1904004	1832424	71580	3.8
9	2019	Mar	66	63.5	1901736	1831118	70618	3.7
9	2019	Apr	65.9	63.5	1901072	1831159	69913	3.7
9	2019	May	66	63.6	1902550	1832938	69612	3.7
9	2019	Jun	66.1	63.7	1906099	1836251	69848	3.7
9	2019	Jul	66.3	63.9	1911681	1841106	70575	3.7
9	2019	Aug	66.5	64	1917687	1846263	71424	3.7
9	2019	Sep	66.7	64.2	1923109	1851012	72097	3.7
9	2019	Oct	66.8	64.3	1926753	1854295	72458	3.8
9	2019	Nov	66.8	64.3	1926916	1854543	72373	3.8
9	2019	Dec	66.8	64.3	1926276	1853997	72279	3.8
9	2020	Jan	66.9	64.4	1929340	1857116	72224	3.7
9	2020	Feb	66.9	64.4	1930492	1857851	72641	3.8
10	2010	Jan	62.2	56.8	429710	392087	37623	8.8
10	2010	Feb	62.3	56.8	430100	392564	37536	8.7
10	2010	Mar	62.3	56.9	430874	393526	37348	8.7
10	2010	Apr	61.6	56.3	431940	394829	37111	8.6
10	2010	May	61.7	56.4	433161	396298	36863	8.5
10	2010	Jun	61.8	56.6	434360	397725	36635	8.4
10	2010	Jul	61.9	56.7	435388	398956	36432	8.4
10	2010	Aug	62	56.8	436206	399954	36252	8.3
10	2010	Sep	62	56.9	436872	400796	36076	8.3
10	2010	Oct	62	56.9	437508	401654	35854	8.2
10	2010	Nov	62	57	438229	402670	35559	8.1
10	2010	Dec	62.1	57.1	439063	403877	35186	8
10	2011	Jan	62.2	57.3	439961	405199	34762	7.9
10	2011	Feb	62.2	57.4	440818	406489	34329	7.8
10	2011	Mar	62.3	57.5	441523	407596	33927	7.7
10	2011	Apr	62.3	57.6	442053	408447	33606	7.6
10	2011	May	62.3	57.6	442477	409083	33394	7.5
10	2011	Jun	62.3	57.6	442907	409638	33269	7.5
10	2011	Jul	62.3	57.7	443436	410268	33168	7.5
10	2011	Aug	62.4	57.7	444069	411041	33028	7.4
10	2011	Sep	62.4	57.8	444727	411921	32806	7.4
10	2011	Oct	62.4	57.8	445322	412809	32513	7.3
10	2011	Nov	62.4	57.9	445777	413575	32202	7.2
10	2011	Dec	62.4	57.9	446079	414139	31940	7.2
10	2012	Jan	62.4	57.9	446257	414481	31776	7.1
10	2012	Feb	62.3	57.9	446336	414607	31729	7.1
10	2012	Mar	62.3	57.8	446320	414526	31794	7.1
10	2012	Apr	62.2	57.8	446198	414272	31926	7.2
10	2012	May	62.1	57.7	445997	413923	32074	7.2
10	2012	Jun	62.1	57.6	445764	413567	32197	7.2
10	2012	Jul	62	57.5	445538	413259	32279	7.2
10	2012	Aug	61.9	57.4	445340	413013	32327	7.3
10	2012	Sep	61.8	57.3	445164	412814	32350	7.3
10	2012	Oct	61.7	57.2	444940	412600	32340	7.3
10	2012	Nov	61.6	57.1	444605	412320	32285	7.3
10	2012	Dec	61.4	57	444127	411957	32170	7.2
10	2013	Jan	61.3	56.9	443397	411523	31874	7.2
10	2013	Feb	61.1	56.8	442719	411093	31626	7.1
10	2013	Mar	61	56.7	442088	410795	31293	7.1
10	2013	Apr	60.9	56.6	441632	410760	30872	7
10	2013	May	60.8	56.6	441417	411042	30375	6.9
10	2013	Jun	60.8	56.6	441465	411635	29830	6.8
10	2013	Jul	60.7	56.7	441767	412491	29276	6.6
10	2013	Aug	60.7	56.8	442276	413528	28748	6.5
10	2013	Sep	60.7	56.9	442934	414644	28290	6.4
10	2013	Oct	60.8	57	443679	415741	27938	6.3
10	2013	Nov	60.8	57	444459	416768	27691	6.2
10	2013	Dec	60.9	57.1	445267	417747	27520	6.2
10	2014	Jan	60.8	57.1	445213	417878	27335	6.1
10	2014	Feb	60.9	57.2	446233	419053	27180	6.1
10	2014	Mar	61	57.3	447463	420458	27005	6
10	2014	Apr	61.1	57.5	448871	422058	26813	6
10	2014	May	61.3	57.6	450377	423782	26595	5.9
10	2014	Jun	61.4	57.8	451889	425554	26335	5.8
10	2014	Jul	61.5	58	453306	427300	26006	5.7
10	2014	Aug	61.6	58.2	454580	428982	25598	5.6
10	2014	Sep	61.7	58.3	455694	430577	25117	5.5
10	2014	Oct	61.8	58.4	456682	432090	24592	5.4
10	2014	Nov	61.8	58.6	457601	433528	24073	5.3
10	2014	Dec	61.9	58.7	458527	434900	23627	5.2
10	2015	Jan	61.9	58.8	459337	436031	23306	5.1
10	2015	Feb	62	58.9	460361	437278	23083	5
10	2015	Mar	62.1	59	461462	438529	22933	5
10	2015	Apr	62.2	59.2	462628	439812	22816	4.9
10	2015	May	62.3	59.3	463834	441121	22713	4.9
10	2015	Jun	62.4	59.4	465051	442431	22620	4.9
10	2015	Jul	62.5	59.5	466269	443723	22546	4.8
10	2015	Aug	62.6	59.6	467458	444976	22482	4.8
10	2015	Sep	62.7	59.7	468575	446170	22405	4.8
10	2015	Oct	62.8	59.8	469587	447293	22294	4.7
10	2015	Nov	62.8	59.9	470458	448325	22133	4.7
10	2015	Dec	62.9	60	471140	449216	21924	4.7
10	2016	Jan	62.9	60	471595	449898	21697	4.6
10	2016	Feb	62.9	60	471837	450340	21497	4.6
10	2016	Mar	62.8	60	471918	450572	21346	4.5
10	2016	Apr	62.8	59.9	471907	450661	21246	4.5
10	2016	May	62.7	59.9	471862	450673	21189	4.5
10	2016	Jun	62.6	59.8	471801	450639	21162	4.5
10	2016	Jul	62.6	59.8	471737	450581	21156	4.5
10	2016	Aug	62.5	59.7	471709	450537	21172	4.5
10	2016	Sep	62.5	59.7	471784	450555	21229	4.5
10	2016	Oct	62.4	59.6	471996	450665	21331	4.5
10	2016	Nov	62.4	59.6	472358	450888	21470	4.5
10	2016	Dec	62.4	59.6	472852	451229	21623	4.6
10	2017	Jan	62.4	59.6	473437	451676	21761	4.6
10	2017	Feb	62.5	59.6	474041	452188	21853	4.6
10	2017	Mar	62.5	59.6	474607	452714	21893	4.6
10	2017	Apr	62.5	59.7	475140	453265	21875	4.6
10	2017	May	62.5	59.7	475650	453866	21784	4.6
10	2017	Jun	62.6	59.7	476148	454517	21631	4.5
10	2017	Jul	62.6	59.8	476641	455201	21440	4.5
10	2017	Aug	62.6	59.8	477114	455884	21230	4.4
10	2017	Sep	62.6	59.8	477547	456544	21003	4.4
10	2017	Oct	62.5	59.8	477946	457190	20756	4.3
10	2017	Nov	62.5	59.9	478329	457847	20482	4.3
10	2017	Dec	62.5	59.9	478746	458573	20173	4.2
10	2018	Jan	62.5	60	479247	459416	19831	4.1
10	2018	Feb	62.6	60	479842	460368	19474	4.1
10	2018	Mar	62.6	60.1	480470	461344	19126	4
10	2018	Apr	62.6	60.2	481017	462207	18810	3.9
10	2018	May	62.6	60.2	481433	462894	18539	3.9
10	2018	Jun	62.6	60.2	481729	463440	18289	3.8
10	2018	Jul	62.6	60.2	481958	463926	18032	3.7
10	2018	Aug	62.5	60.2	482212	464441	17771	3.7
10	2018	Sep	62.5	60.3	482562	465046	17516	3.6
10	2018	Oct	62.5	60.3	483047	465754	17293	3.6
10	2018	Nov	62.5	60.3	483656	466524	17132	3.5
10	2018	Dec	62.6	60.4	484314	467252	17062	3.5
10	2019	Jan	62.6	60.4	484902	467818	17084	3.5
10	2019	Feb	62.6	60.4	485355	468169	17186	3.5
10	2019	Mar	62.6	60.4	485708	468349	17359	3.6
10	2019	Apr	62.6	60.3	486041	468449	17592	3.6
10	2019	May	62.6	60.3	486431	468549	17882	3.7
10	2019	Jun	62.6	60.3	486936	468707	18229	3.7
10	2019	Jul	62.6	60.2	487583	468959	18624	3.8
10	2019	Aug	62.6	60.2	488173	469178	18995	3.9
10	2019	Sep	62.6	60.2	488694	469406	19288	3.9
10	2019	Oct	62.6	60.1	488997	469532	19465	4
10	2019	Nov	62.5	60	488945	469497	19448	4
10	2019	Dec	62.5	60	488861	469461	19400	4
10	2020	Jan	62.4	59.9	488917	469519	19398	4
10	2020	Feb	62.4	59.9	489107	469879	19228	3.9
11	2010	Jan	69.5	62.7	341698	308097	33601	9.8
11	2010	Feb	69.7	62.9	343090	309848	33242	9.7
11	2010	Mar	69.9	63.2	344639	311743	32896	9.5
11	2010	Apr	68.9	62.4	346075	313469	32606	9.4
11	2010	May	69	62.5	347182	314804	32378	9.3
11	2010	Jun	69	62.6	347745	315533	32212	9.3
11	2010	Jul	68.8	62.5	347700	315592	32108	9.2
11	2010	Aug	68.6	62.2	347239	315168	32071	9.2
11	2010	Sep	68.4	62	346809	314691	32118	9.3
11	2010	Oct	68.2	61.9	346825	314550	32275	9.3
11	2010	Nov	68.2	61.8	347414	314840	32574	9.4
11	2010	Dec	68.3	61.8	348370	315322	33048	9.5
11	2011	Jan	68.3	61.7	349321	315627	33694	9.6
11	2011	Feb	68.3	61.6	349978	315513	34465	9.8
11	2011	Mar	68.3	61.4	350284	315013	35271	10.1
11	2011	Apr	68.2	61.2	350390	314391	35999	10.3
11	2011	May	68	60.9	350399	313874	36525	10.4
11	2011	Jun	67.9	60.8	350403	313644	36759	10.5
11	2011	Jul	67.8	60.7	350477	313785	36692	10.5
11	2011	Aug	67.7	60.7	350648	314255	36393	10.4
11	2011	Sep	67.6	60.7	350898	314926	35972	10.3
11	2011	Oct	67.6	60.7	351288	315746	35542	10.1
11	2011	Nov	67.6	60.8	351902	316729	35173	10
11	2011	Dec	67.6	61	352823	317962	34861	9.9
11	2012	Jan	67.8	61.2	354177	319618	34559	9.8
11	2012	Feb	68	61.5	355916	321716	34200	9.6
11	2012	Mar	68.3	61.8	357875	324111	33764	9.4
11	2012	Apr	68.5	62.2	359861	326567	33294	9.3
11	2012	May	68.8	62.6	361825	328974	32851	9.1
11	2012	Jun	69.1	62.9	363859	331365	32494	8.9
11	2012	Jul	69.4	63.2	366001	333727	32274	8.8
11	2012	Aug	69.6	63.5	368205	335978	32227	8.8
11	2012	Sep	69.9	63.8	370337	338011	32326	8.7
11	2012	Oct	70.1	64	372198	339705	32493	8.7
11	2012	Nov	70.3	64.1	373663	341013	32650	8.7
11	2012	Dec	70.4	64.2	374704	341961	32743	8.7
11	2013	Jan	70.2	64.1	374653	341899	32754	8.7
11	2013	Feb	70.2	64	374866	342173	32693	8.7
11	2013	Mar	70.1	64	374843	342279	32564	8.7
11	2013	Apr	69.9	63.9	374688	342323	32365	8.6
11	2013	May	69.7	63.7	374435	342266	32169	8.6
11	2013	Jun	69.6	63.6	374101	342076	32025	8.6
11	2013	Jul	69.4	63.5	373806	341917	31889	8.5
11	2013	Aug	69.3	63.4	373615	341931	31684	8.5
11	2013	Sep	69.1	63.3	373517	342135	31382	8.4
11	2013	Oct	69	63.3	373482	342472	31010	8.3
11	2013	Nov	69	63.3	373445	342832	30613	8.2
11	2013	Dec	68.9	63.3	373370	343140	30230	8.1
11	2014	Jan	68.8	63.3	373749	343743	30006	8
11	2014	Feb	68.8	63.3	373893	344167	29726	8
11	2014	Mar	68.8	63.4	374359	344815	29544	7.9
11	2014	Apr	68.9	63.5	375249	345775	29474	7.9
11	2014	May	69	63.6	376582	347126	29456	7.8
11	2014	Jun	69.3	63.9	378259	348819	29440	7.8
11	2014	Jul	69.5	64.1	379997	350567	29430	7.7
11	2014	Aug	69.7	64.3	381582	352161	29421	7.7
11	2014	Sep	69.8	64.5	382944	353547	29397	7.7
11	2014	Oct	69.9	64.6	384037	354719	29318	7.6
11	2014	Nov	70	64.7	384866	355700	29166	7.6
11	2014	Dec	70	64.7	385469	356517	28952	7.5
11	2015	Jan	69.9	64.7	385728	357083	28645	7.4
11	2015	Feb	69.9	64.7	386001	357683	28318	7.3
11	2015	Mar	69.8	64.8	386347	358417	27930	7.2
11	2015	Apr	69.8	64.9	386869	359368	27501	7.1
11	2015	May	69.9	65	387566	360496	27070	7
11	2015	Jun	69.9	65.1	388409	361724	26685	6.9
11	2015	Jul	70	65.3	389384	363005	26379	6.8
11	2015	Aug	70.1	65.4	390378	364228	26150	6.7
11	2015	Sep	70.2	65.5	391229	365259	25970	6.6
11	2015	Oct	70.2	65.6	391871	366062	25809	6.6
11	2015	Nov	70.2	65.6	392365	366733	25632	6.5
11	2015	Dec	70.2	65.7	392797	367407	25390	6.5
11	2016	Jan	70.2	65.7	393217	368138	25079	6.4
11	2016	Feb	70.2	65.8	393585	368854	24731	6.3
11	2016	Mar	70.2	65.8	393847	369451	24396	6.2
11	2016	Apr	70.1	65.8	394042	369911	24131	6.1
11	2016	May	70.1	65.8	394254	370284	23970	6.1
11	2016	Jun	70.1	65.8	394532	370630	23902	6.1
11	2016	Jul	70	65.8	394897	371004	23893	6.1
11	2016	Aug	70.1	65.8	395377	371462	23915	6
11	2016	Sep	70.1	65.9	395980	372041	23939	6
11	2016	Oct	70.1	65.9	396657	372715	23942	6
11	2016	Nov	70.2	66	397325	373390	23935	6
11	2016	Dec	70.2	66	397933	373976	23957	6
11	2017	Jan	70.3	66	398514	374473	24041	6
11	2017	Feb	70.3	66	399077	374887	24190	6.1
11	2017	Mar	70.3	66	399617	375233	24384	6.1
11	2017	Apr	70.4	66	400146	375563	24583	6.1
11	2017	May	70.4	66	400658	375913	24745	6.2
11	2017	Jun	70.4	66.1	401121	376292	24829	6.2
11	2017	Jul	70.4	66.1	401520	376715	24805	6.2
11	2017	Aug	70.4	66.1	401846	377197	24649	6.1
11	2017	Sep	70.4	66.2	402130	377757	24373	6.1
11	2017	Oct	70.4	66.2	402442	378403	24039	6
11	2017	Nov	70.4	66.3	402832	379105	23727	5.9
11	2017	Dec	70.5	66.4	403340	379846	23494	5.8
11	2018	Jan	70.6	66.5	403941	380575	23366	5.8
11	2018	Feb	70.6	66.6	404566	381242	23324	5.8
11	2018	Mar	70.7	66.6	405079	381752	23327	5.8
11	2018	Apr	70.7	66.6	405313	381999	23314	5.8
11	2018	May	70.6	66.6	405215	381984	23231	5.7
11	2018	Jun	70.5	66.5	404890	381819	23071	5.7
11	2018	Jul	70.4	66.4	404494	381633	22861	5.7
11	2018	Aug	70.3	66.4	404211	381505	22706	5.6
11	2018	Sep	70.3	66.3	404189	381492	22697	5.6
11	2018	Oct	70.3	66.3	404500	381661	22839	5.6
11	2018	Nov	70.4	66.4	405125	382053	23072	5.7
11	2018	Dec	70.5	66.4	405938	382620	23318	5.7
11	2019	Jan	70.6	66.5	406773	383285	23488	5.8
11	2019	Feb	70.7	66.6	407526	384015	23511	5.8
11	2019	Mar	70.8	66.7	408166	384810	23356	5.7
11	2019	Apr	70.9	66.9	408698	385659	23039	5.6
11	2019	May	70.9	67	409126	386492	22634	5.5
11	2019	Jun	70.9	67.1	409498	387260	22238	5.4
11	2019	Jul	71	67.2	410015	388072	21943	5.4
11	2019	Aug	71.1	67.3	410617	388842	21775	5.3
11	2019	Sep	71.1	67.4	411296	389568	21728	5.3
11	2019	Oct	71.2	67.4	411867	390098	21769	5.3
11	2019	Nov	71.2	67.4	411999	390156	21843	5.3
11	2019	Dec	71.2	67.4	411960	390081	21879	5.3
11	2020	Jan	71.3	67.6	413042	391465	21577	5.2
11	2020	Feb	71.5	67.8	414340	392997	21343	5.2
12	2010	Jan	61.9	55	9087605	8063166	1024439	11.3
12	2010	Feb	62.1	55.2	9121821	8097244	1024577	11.2
12	2010	Mar	62.3	55.4	9153821	8133092	1020729	11.2
12	2010	Apr	61.4	54.6	9181288	8165997	1015291	11.1
12	2010	May	61.5	54.7	9203212	8193577	1009635	11
12	2010	Jun	61.5	54.8	9219282	8212566	1006716	10.9
12	2010	Jul	61.5	54.8	9232148	8223052	1009096	10.9
12	2010	Aug	61.5	54.8	9244915	8229564	1015351	11
12	2010	Sep	61.5	54.7	9256982	8235424	1021558	11
12	2010	Oct	61.5	54.7	9268067	8244529	1023538	11
12	2010	Nov	61.5	54.8	9276191	8257764	1018427	11
12	2010	Dec	61.5	54.8	9280528	8273961	1006567	10.8
12	2011	Jan	61.4	54.9	9283526	8292155	991371	10.7
12	2011	Feb	61.4	54.9	9285256	8308758	976498	10.5
12	2011	Mar	61.3	54.9	9284110	8320238	963872	10.4
12	2011	Apr	61.2	54.9	9280607	8325905	954702	10.3
12	2011	May	61.1	54.9	9278592	8329364	949228	10.2
12	2011	Jun	61.1	54.9	9280695	8336498	944197	10.2
12	2011	Jul	61.1	54.9	9288470	8352288	936182	10.1
12	2011	Aug	61.1	55	9300806	8376656	924150	9.9
12	2011	Sep	61.1	55.1	9314616	8406567	908049	9.7
12	2011	Oct	61.1	55.2	9326979	8437925	889054	9.5
12	2011	Nov	61	55.4	9334508	8465438	869070	9.3
12	2011	Dec	61	55.4	9336389	8486105	850284	9.1
12	2012	Jan	60.9	55.4	9335794	8501196	834598	8.9
12	2012	Feb	60.8	55.5	9337939	8514717	823222	8.8
12	2012	Mar	60.8	55.5	9343664	8527026	816638	8.7
12	2012	Apr	60.8	55.5	9351008	8537711	813297	8.7
12	2012	May	60.8	55.5	9360799	8550238	810561	8.7
12	2012	Jun	60.8	55.6	9373314	8567330	805984	8.6
12	2012	Jul	60.8	55.6	9387003	8589132	797871	8.5
12	2012	Aug	60.8	55.7	9401895	8614461	787434	8.4
12	2012	Sep	60.8	55.8	9418399	8640972	777427	8.3
12	2012	Oct	60.8	55.9	9432438	8663920	768518	8.1
12	2012	Nov	60.8	55.9	9441024	8680395	760629	8.1
12	2012	Dec	60.7	55.9	9443197	8690289	752908	8
12	2013	Jan	60.6	55.8	9432835	8691192	741643	7.9
12	2013	Feb	60.5	55.8	9428334	8696035	732299	7.8
12	2013	Mar	60.5	55.8	9428809	8707601	721208	7.6
12	2013	Apr	60.5	55.9	9438181	8729119	709062	7.5
12	2013	May	60.5	56	9451917	8754618	697299	7.4
12	2013	Jun	60.5	56.1	9464347	8777249	687098	7.3
12	2013	Jul	60.4	56.1	9471902	8793877	678025	7.2
12	2013	Aug	60.4	56.1	9472085	8804454	667631	7
12	2013	Sep	60.2	56.1	9467499	8812072	655427	6.9
12	2013	Oct	60.1	56	9466257	8821673	644584	6.8
12	2013	Nov	60.1	56	9474475	8837186	637289	6.7
12	2013	Dec	60.1	56.1	9492133	8858395	633738	6.7
12	2014	Jan	60.1	56.1	9507295	8876713	630582	6.6
12	2014	Feb	60.2	56.2	9530587	8901874	628713	6.6
12	2014	Mar	60.2	56.3	9548725	8922770	625955	6.6
12	2014	Apr	60.2	56.3	9558358	8937039	621319	6.5
12	2014	May	60.1	56.3	9562152	8947972	614180	6.4
12	2014	Jun	60.1	56.3	9566095	8960512	605583	6.3
12	2014	Jul	60	56.3	9572055	8974837	597218	6.2
12	2014	Aug	60	56.3	9581024	8990701	590323	6.2
12	2014	Sep	59.9	56.3	9590936	9006338	584598	6.1
12	2014	Oct	59.9	56.3	9596758	9018580	578178	6
12	2014	Nov	59.7	56.2	9595288	9025213	570075	5.9
12	2014	Dec	59.6	56.1	9589346	9027644	561702	5.9
12	2015	Jan	59.4	56	9569905	9016407	553498	5.8
12	2015	Feb	59.3	55.9	9565203	9017363	547840	5.7
12	2015	Mar	59.2	55.8	9565556	9022257	543299	5.7
12	2015	Apr	59.1	55.8	9570756	9032096	538660	5.6
12	2015	May	59.1	55.8	9577677	9044418	533259	5.6
12	2015	Jun	59	55.8	9583120	9056301	526819	5.5
12	2015	Jul	58.9	55.8	9587977	9067857	520120	5.4
12	2015	Aug	58.9	55.7	9594182	9080367	513815	5.4
12	2015	Sep	58.8	55.7	9603770	9096410	507360	5.3
12	2015	Oct	58.8	55.7	9620273	9119357	500916	5.2
12	2015	Nov	58.8	55.8	9643903	9148790	495113	5.1
12	2015	Dec	58.9	55.9	9669925	9180636	489289	5.1
12	2016	Jan	58.9	56	9693636	9210489	483147	5
12	2016	Feb	58.9	56.1	9712896	9235561	477335	4.9
12	2016	Mar	58.9	56.1	9727593	9255436	472157	4.9
12	2016	Apr	58.9	56.1	9740951	9272309	468642	4.8
12	2016	May	58.9	56.1	9757831	9290270	467561	4.8
12	2016	Jun	58.9	56.1	9780140	9311839	468301	4.8
12	2016	Jul	59	56.2	9807134	9337571	469563	4.8
12	2016	Aug	59.1	56.3	9836968	9366121	470847	4.8
12	2016	Sep	59.2	56.3	9867303	9395114	472189	4.8
12	2016	Oct	59.2	56.4	9895233	9423034	472199	4.8
12	2016	Nov	59.3	56.5	9921043	9451798	469245	4.7
12	2016	Dec	59.3	56.6	9946734	9483247	463487	4.7
12	2017	Jan	59.4	56.7	9973240	9517115	456125	4.6
12	2017	Feb	59.5	56.8	10000028	9552058	447970	4.5
12	2017	Mar	59.5	56.9	10024862	9584532	440330	4.4
12	2017	Apr	59.6	57	10046850	9613039	433811	4.3
12	2017	May	59.6	57.1	10064912	9636809	428103	4.3
12	2017	Jun	59.6	57.1	10078216	9654802	423414	4.2
12	2017	Jul	59.6	57.1	10087485	9667659	419826	4.2
12	2017	Aug	59.5	57	10092485	9676162	416323	4.1
12	2017	Sep	59.4	57	10094477	9682213	412264	4.1
12	2017	Oct	59.4	57	10095930	9688120	407810	4
12	2017	Nov	59.3	56.9	10097965	9694399	403566	4
12	2017	Dec	59.2	56.9	10102103	9702948	399155	4
12	2018	Jan	59.2	56.9	10110173	9715663	394510	3.9
12	2018	Feb	59.2	56.9	10123101	9733243	389858	3.9
12	2018	Mar	59.3	57	10138504	9753654	384850	3.8
12	2018	Apr	59.3	57	10150992	9772198	378794	3.7
12	2018	May	59.2	57.1	10158287	9786582	371705	3.7
12	2018	Jun	59.2	57.1	10162862	9798986	363876	3.6
12	2018	Jul	59.1	57.1	10167793	9811796	355997	3.5
12	2018	Aug	59.1	57.1	10177203	9827109	350094	3.4
12	2018	Sep	59.1	57.1	10192858	9845567	347291	3.4
12	2018	Oct	59.2	57.2	10213136	9865690	347446	3.4
12	2018	Nov	59.2	57.2	10234393	9885052	349341	3.4
12	2018	Dec	59.3	57.3	10251451	9900101	351350	3.4
12	2019	Jan	59.3	57.2	10260524	9908830	351694	3.4
12	2019	Feb	59.2	57.2	10261124	9912103	349021	3.4
12	2019	Mar	59.2	57.2	10259007	9915067	343940	3.4
12	2019	Apr	59.1	57.2	10262056	9924507	337549	3.3
12	2019	May	59.1	57.2	10274886	9943938	330948	3.2
12	2019	Jun	59.2	57.3	10298460	9973583	324877	3.2
12	2019	Jul	59.3	57.5	10333418	10015016	318402	3.1
12	2019	Aug	59.5	57.7	10370434	10059338	311096	3
12	2019	Sep	59.6	57.8	10402699	10098918	303781	2.9
12	2019	Oct	59.6	57.9	10423379	10125431	297948	2.9
12	2019	Nov	59.5	57.8	10423269	10126546	296723	2.8
12	2019	Dec	59.4	57.8	10419034	10121594	297440	2.9
12	2020	Jan	59.5	57.8	10440312	10148929	291383	2.8
12	2020	Feb	59.5	57.9	10455537	10164847	290690	2.8
13	2010	Jan	65.1	58.3	4792496	4289733	502763	10.5
13	2010	Feb	63.8	57	4699011	4199161	499850	10.6
13	2010	Mar	63.4	56.7	4674480	4179456	495024	10.6
13	2010	Apr	64.2	57.4	4669893	4179931	489962	10.5
13	2010	May	64.1	57.5	4670823	4185382	485441	10.4
13	2010	Jun	64.1	57.5	4673422	4190456	482966	10.3
13	2010	Jul	64.1	57.4	4677782	4193763	484019	10.3
13	2010	Aug	64.1	57.4	4684376	4195887	488489	10.4
13	2010	Sep	64.1	57.4	4691739	4197433	494306	10.5
13	2010	Oct	64.2	57.3	4698737	4199836	498901	10.6
13	2010	Nov	64.2	57.3	4704274	4203785	500489	10.6
13	2010	Dec	64.2	57.4	4708131	4209434	498697	10.6
13	2011	Jan	64.2	57.4	4711909	4216993	494916	10.5
13	2011	Feb	64.2	57.5	4716445	4225541	490904	10.4
13	2011	Mar	64.2	57.6	4721391	4233713	487678	10.3
13	2011	Apr	64.2	57.6	4727041	4240677	486364	10.3
13	2011	May	64.3	57.6	4734686	4246820	487866	10.3
13	2011	Jun	64.3	57.7	4744120	4253512	490608	10.3
13	2011	Jul	64.4	57.7	4754219	4262111	492108	10.4
13	2011	Aug	64.5	57.8	4763808	4272812	490996	10.3
13	2011	Sep	64.5	57.9	4771878	4284901	486977	10.2
13	2011	Oct	64.5	58	4778084	4297025	481059	10.1
13	2011	Nov	64.5	58.1	4781837	4307505	474332	9.9
13	2011	Dec	64.4	58.1	4783117	4315397	467720	9.8
13	2012	Jan	64.4	58.1	4783176	4321220	461956	9.7
13	2012	Feb	64.3	58.2	4784093	4326397	457696	9.6
13	2012	Mar	64.3	58.2	4786203	4331046	455157	9.5
13	2012	Apr	64.2	58.1	4787780	4334976	452804	9.5
13	2012	May	64.2	58.1	4788509	4339280	449229	9.4
13	2012	Jun	64.1	58.1	4788789	4344755	444034	9.3
13	2012	Jul	64	58.2	4788888	4351369	437519	9.1
13	2012	Aug	64	58.2	4789528	4358490	431038	9
13	2012	Sep	63.9	58.2	4791180	4365122	426058	8.9
13	2012	Oct	63.9	58.2	4791998	4369522	422476	8.8
13	2012	Nov	63.8	58.2	4790509	4370629	419880	8.8
13	2012	Dec	63.7	58.1	4786110	4368574	417536	8.7
13	2013	Jan	63.6	58.1	4784092	4368873	415219	8.7
13	2013	Feb	63.5	58	4776080	4363850	412230	8.6
13	2013	Mar	63.3	57.9	4769314	4361032	408282	8.6
13	2013	Apr	63.2	57.9	4765488	4362061	403427	8.5
13	2013	May	63.1	57.9	4763632	4365206	398426	8.4
13	2013	Jun	63.1	57.8	4761816	4368131	393685	8.3
13	2013	Jul	63	57.8	4758794	4369634	389160	8.2
13	2013	Aug	62.8	57.7	4753285	4369676	383609	8.1
13	2013	Sep	62.7	57.7	4745704	4369134	376570	7.9
13	2013	Oct	62.5	57.6	4739064	4369491	369573	7.8
13	2013	Nov	62.4	57.6	4735656	4372080	363576	7.7
13	2013	Dec	62.3	57.6	4735546	4376785	358761	7.6
13	2014	Jan	62.1	57.5	4726956	4373230	353726	7.5
13	2014	Feb	62.1	57.5	4729303	4379438	349865	7.4
13	2014	Mar	62.1	57.5	4731773	4384441	347332	7.3
13	2014	Apr	62.1	57.5	4733556	4387243	346313	7.3
13	2014	May	62	57.5	4734814	4389356	345458	7.3
13	2014	Jun	62	57.5	4736889	4393203	343686	7.3
13	2014	Jul	61.9	57.5	4739528	4399189	340339	7.2
13	2014	Aug	61.9	57.5	4742889	4407516	335373	7.1
13	2014	Sep	61.9	57.6	4746854	4417659	329195	6.9
13	2014	Oct	61.8	57.6	4749902	4428148	321754	6.8
13	2014	Nov	61.8	57.7	4751105	4437331	313774	6.6
13	2014	Dec	61.7	57.7	4752078	4445016	307062	6.5
13	2015	Jan	61.6	57.7	4748803	4445723	303080	6.4
13	2015	Feb	61.6	57.7	4751772	4451188	300584	6.3
13	2015	Mar	61.6	57.7	4755537	4456948	298589	6.3
13	2015	Apr	61.5	57.7	4759405	4463390	296015	6.2
13	2015	May	61.5	57.7	4762195	4469733	292462	6.1
13	2015	Jun	61.4	57.7	4763178	4475201	287977	6
13	2015	Jul	61.4	57.7	4763659	4480434	283225	5.9
13	2015	Aug	61.3	57.7	4765560	4486687	278873	5.9
13	2015	Sep	61.3	57.8	4770601	4495676	274925	5.8
13	2015	Oct	61.3	57.9	4780898	4509137	271761	5.7
13	2015	Nov	61.5	58	4796810	4526995	269815	5.6
13	2015	Dec	61.6	58.2	4815799	4547331	268468	5.6
13	2016	Jan	61.8	58.4	4834723	4567840	266883	5.5
13	2016	Feb	61.9	58.5	4851945	4586811	265134	5.5
13	2016	Mar	62	58.7	4866685	4603473	263212	5.4
13	2016	Apr	62.1	58.8	4879584	4618035	261549	5.4
13	2016	May	62.2	58.9	4892540	4631611	260929	5.3
13	2016	Jun	62.3	59	4906531	4644985	261546	5.3
13	2016	Jul	62.4	59.1	4921529	4658552	262977	5.3
13	2016	Aug	62.5	59.2	4936866	4671982	264884	5.4
13	2016	Sep	62.6	59.2	4951558	4684588	266970	5.4
13	2016	Oct	62.7	59.3	4964333	4696231	268102	5.4
13	2016	Nov	62.8	59.4	4975347	4708188	267159	5.4
13	2016	Dec	62.8	59.5	4985686	4721455	264231	5.3
13	2017	Jan	62.9	59.6	4996271	4736145	260126	5.2
13	2017	Feb	63	59.8	5007182	4751931	255251	5.1
13	2017	Mar	63	59.9	5017944	4767674	250270	5
13	2017	Apr	63.1	60	5029137	4783506	245631	4.9
13	2017	May	63.2	60.2	5040587	4799555	241032	4.8
13	2017	Jun	63.2	60.3	5051610	4814938	236672	4.7
13	2017	Jul	63.3	60.4	5061746	4828823	232923	4.6
13	2017	Aug	63.3	60.5	5069767	4840222	229545	4.5
13	2017	Sep	63.3	60.5	5075111	4848794	226317	4.5
13	2017	Oct	63.3	60.5	5078141	4854838	223303	4.4
13	2017	Nov	63.3	60.5	5079195	4858501	220694	4.3
13	2017	Dec	63.2	60.5	5079132	4861087	218045	4.3
13	2018	Jan	63.1	60.5	5079500	4864151	215349	4.2
13	2018	Feb	63.1	60.5	5081503	4868724	212779	4.2
13	2018	Mar	63.1	60.5	5084498	4874374	210124	4.1
13	2018	Apr	63	60.5	5085773	4878845	206928	4.1
13	2018	May	62.9	60.4	5083973	4880642	203331	4
13	2018	Jun	62.8	60.4	5080086	4880535	199551	3.9
13	2018	Jul	62.7	60.3	5075575	4879741	195834	3.9
13	2018	Aug	62.6	60.2	5072981	4879769	193212	3.8
13	2018	Sep	62.5	60.2	5073808	4881688	192120	3.8
13	2018	Oct	62.5	60.1	5077828	4885507	192321	3.8
13	2018	Nov	62.5	60.1	5083564	4890498	193066	3.8
13	2018	Dec	62.5	60.1	5088671	4895143	193528	3.8
13	2019	Jan	62.5	60.1	5091021	4898096	192925	3.8
13	2019	Feb	62.4	60.1	5089643	4898884	190759	3.7
13	2019	Mar	62.3	60	5086452	4898827	187625	3.7
13	2019	Apr	62.2	60	5084588	4900389	184199	3.6
13	2019	May	62.2	60	5086318	4905393	180925	3.6
13	2019	Jun	62.2	60	5092563	4914704	177859	3.5
13	2019	Jul	62.3	60.1	5104207	4929889	174318	3.4
13	2019	Aug	62.3	60.3	5117470	4947459	170011	3.3
13	2019	Sep	62.4	60.4	5129851	4964375	165476	3.2
13	2019	Oct	62.4	60.5	5138363	4976473	161890	3.2
13	2019	Nov	62.4	60.4	5138942	4977732	161210	3.1
13	2019	Dec	62.3	60.3	5137642	4975936	161706	3.1
13	2020	Jan	62.4	60.4	5147616	4988005	159611	3.1
13	2020	Feb	62.4	60.5	5156201	4995066	161135	3.1
15	2010	Jan	64.3	59.7	633386	588348	45038	7.1
15	2010	Feb	64.5	59.9	635460	590772	44688	7
15	2010	Mar	64.7	60.2	638106	593618	44488	7
15	2010	Apr	61.7	57.4	641085	596613	44472	6.9
15	2010	May	61.9	57.6	644088	599477	44611	6.9
15	2010	Jun	62.1	57.8	646940	602056	44884	6.9
15	2010	Jul	62.2	57.9	649539	604352	45187	7
15	2010	Aug	62.3	58	651813	606417	45396	7
15	2010	Sep	62.5	58.1	653823	608354	45469	7
15	2010	Oct	62.6	58.3	655746	610345	45401	6.9
15	2010	Nov	62.7	58.4	657619	612429	45190	6.9
15	2010	Dec	62.8	58.5	659367	614455	44912	6.8
15	2011	Jan	62.9	58.6	660878	616210	44668	6.8
15	2011	Feb	63	58.7	661975	617480	44495	6.7
15	2011	Mar	62.9	58.7	662537	618118	44419	6.7
15	2011	Apr	62.9	58.7	662598	618126	44472	6.7
15	2011	May	62.8	58.6	662280	617623	44657	6.7
15	2011	Jun	62.7	58.5	661708	616779	44929	6.8
15	2011	Jul	62.6	58.3	661013	615789	45224	6.8
15	2011	Aug	62.5	58.2	660222	614761	45461	6.9
15	2011	Sep	62.3	58	659208	613689	45519	6.9
15	2011	Oct	62.1	57.8	657897	612521	45376	6.9
15	2011	Nov	61.9	57.7	656316	611242	45074	6.9
15	2011	Dec	61.7	57.5	654557	609940	44617	6.8
15	2012	Jan	61.5	57.4	652737	608722	44015	6.7
15	2012	Feb	61.3	57.2	650981	607650	43331	6.7
15	2012	Mar	61.1	57.1	649380	606805	42575	6.6
15	2012	Apr	60.9	57	648004	606292	41712	6.4
15	2012	May	60.8	57	646905	606172	40733	6.3
15	2012	Jun	60.7	56.9	646109	606476	39633	6.1
15	2012	Jul	60.6	57	645600	607153	38447	6
15	2012	Aug	60.5	57	645340	608092	37248	5.8
15	2012	Sep	60.5	57.1	645309	609187	36122	5.6
15	2012	Oct	60.4	57.2	645403	610281	35122	5.4
15	2012	Nov	60.4	57.2	645533	611255	34278	5.3
15	2012	Dec	60.4	57.2	645678	612064	33614	5.2
15	2013	Jan	60.3	57.2	645877	612783	33094	5.1
15	2013	Feb	60.3	57.3	646236	613585	32651	5.1
15	2013	Mar	60.4	57.3	646805	614550	32255	5
15	2013	Apr	60.4	57.4	647585	615685	31900	4.9
15	2013	May	60.4	57.5	648595	616980	31615	4.9
15	2013	Jun	60.5	57.6	649820	618374	31446	4.8
15	2013	Jul	60.6	57.7	651268	619844	31424	4.8
15	2013	Aug	60.7	57.8	652939	621437	31502	4.8
15	2013	Sep	60.9	57.9	654749	623139	31610	4.8
15	2013	Oct	61	58.1	656561	624895	31666	4.8
15	2013	Nov	61.2	58.2	658284	626679	31605	4.8
15	2013	Dec	61.3	58.4	659842	628445	31397	4.8
15	2014	Jan	61.3	58.4	660487	629478	31009	4.7
15	2014	Feb	61.4	58.6	661607	630998	30609	4.6
15	2014	Mar	61.5	58.7	662647	632399	30248	4.6
15	2014	Apr	61.5	58.8	663661	633712	29949	4.5
15	2014	May	61.6	58.9	664619	634978	29641	4.5
15	2014	Jun	61.7	59	665525	636257	29268	4.4
15	2014	Jul	61.7	59	666335	637494	28841	4.3
15	2014	Aug	61.7	59.1	667034	638632	28402	4.3
15	2014	Sep	61.8	59.2	667668	639674	27994	4.2
15	2014	Oct	61.8	59.2	668290	640647	27643	4.1
15	2014	Nov	61.8	59.3	668912	641566	27346	4.1
15	2014	Dec	61.8	59.3	669552	642477	27075	4
15	2015	Jan	61.9	59.4	670037	643262	26775	4
15	2015	Feb	61.9	59.4	670669	644276	26393	3.9
15	2015	Mar	61.9	59.5	671270	645400	25870	3.9
15	2015	Apr	62	59.6	671883	646611	25272	3.8
15	2015	May	62	59.7	672531	647848	24683	3.7
15	2015	Jun	62	59.8	673202	649060	24142	3.6
15	2015	Jul	62.1	59.9	673942	650288	23654	3.5
15	2015	Aug	62.1	59.9	674760	651571	23189	3.4
15	2015	Sep	62.1	60	675591	652891	22700	3.4
15	2015	Oct	62.2	60.1	676414	654236	22178	3.3
15	2015	Nov	62.2	60.2	677189	655529	21660	3.2
15	2015	Dec	62.2	60.3	677861	656656	21205	3.1
15	2016	Jan	62.2	60.3	678412	657553	20859	3.1
15	2016	Feb	62.2	60.3	678930	658255	20675	3
15	2016	Mar	62.3	60.4	679536	658903	20633	3
15	2016	Apr	62.3	60.4	680322	659690	20632	3
15	2016	May	62.4	60.5	681389	660776	20613	3
15	2016	Jun	62.5	60.6	682721	662181	20540	3
15	2016	Jul	62.6	60.7	684127	663757	20370	3
15	2016	Aug	62.7	60.8	685410	665279	20131	2.9
15	2016	Sep	62.7	60.9	686464	666585	19879	2.9
15	2016	Oct	62.8	61	687208	667580	19628	2.9
15	2016	Nov	62.8	61.1	687668	668305	19363	2.8
15	2016	Dec	62.8	61.1	687924	668843	19081	2.8
15	2017	Jan	62.9	61.1	688024	669251	18773	2.7
15	2017	Feb	62.9	61.2	687957	669537	18420	2.7
15	2017	Mar	62.9	61.2	687625	669607	18018	2.6
15	2017	Apr	62.8	61.2	686961	669390	17571	2.6
15	2017	May	62.7	61.1	685965	668886	17079	2.5
15	2017	Jun	62.6	61.1	684689	668120	16569	2.4
15	2017	Jul	62.5	61	683294	667191	16103	2.4
15	2017	Aug	62.4	60.9	681950	666235	15715	2.3
15	2017	Sep	62.2	60.8	680790	665358	15432	2.3
15	2017	Oct	62.2	60.8	679933	664648	15285	2.2
15	2017	Nov	62.1	60.7	679401	664138	15263	2.2
15	2017	Dec	62.1	60.7	679141	663827	15314	2.3
15	2018	Jan	62.1	60.7	679065	663660	15405	2.3
15	2018	Feb	62.1	60.7	679046	663511	15535	2.3
15	2018	Mar	62.1	60.7	678937	663231	15706	2.3
15	2018	Apr	62.1	60.6	678570	662636	15934	2.3
15	2018	May	62	60.5	677814	661581	16233	2.4
15	2018	Jun	61.9	60.4	676721	660105	16616	2.5
15	2018	Jul	61.8	60.2	675415	658357	17058	2.5
15	2018	Aug	61.7	60.1	674009	656498	17511	2.6
15	2018	Sep	61.5	59.9	672600	654679	17921	2.7
15	2018	Oct	61.4	59.8	671226	652992	18234	2.7
15	2018	Nov	61.3	59.6	669859	651429	18430	2.8
15	2018	Dec	61.2	59.5	668439	649931	18508	2.8
15	2019	Jan	61.1	59.4	666938	648451	18487	2.8
15	2019	Feb	60.9	59.2	665402	647012	18390	2.8
15	2019	Mar	60.8	59.1	664000	645727	18273	2.8
15	2019	Apr	60.7	59.1	662973	644777	18196	2.7
15	2019	May	60.7	59	662531	644353	18178	2.7
15	2019	Jun	60.7	59.1	662720	644530	18190	2.7
15	2019	Jul	60.8	59.1	663544	645387	18157	2.7
15	2019	Aug	60.9	59.3	664641	646583	18058	2.7
15	2019	Sep	61	59.4	665785	647883	17902	2.7
15	2019	Oct	61.1	59.5	666583	648848	17735	2.7
15	2019	Nov	61.1	59.5	666654	648988	17666	2.6
15	2019	Dec	61.1	59.5	666539	648873	17666	2.7
15	2020	Jan	61.3	59.6	668169	650377	17792	2.7
15	2020	Feb	61.4	59.7	669073	651240	17833	2.7
16	2010	Jan	65.7	59.7	760445	690531	69914	9.2
16	2010	Feb	65.7	59.7	761252	691539	69713	9.2
16	2010	Mar	65.7	59.7	761819	692372	69447	9.1
16	2010	Apr	65.5	59.6	762064	692947	69117	9.1
16	2010	May	65.4	59.5	761960	693237	68723	9
16	2010	Jun	65.4	59.5	761585	693255	68330	9
16	2010	Jul	65.2	59.4	761044	693097	67947	8.9
16	2010	Aug	65.1	59.3	760533	692962	67571	8.9
16	2010	Sep	65	59.3	760283	693038	67245	8.8
16	2010	Oct	65	59.3	760379	693396	66983	8.8
16	2010	Nov	65	59.3	760770	693979	66791	8.8
16	2010	Dec	65	59.3	761301	694664	66637	8.8
16	2011	Jan	64.9	59.3	761874	695383	66491	8.7
16	2011	Feb	64.9	59.3	762426	696138	66288	8.7
16	2011	Mar	64.9	59.3	762885	696898	65987	8.6
16	2011	Apr	64.9	59.3	763277	697709	65568	8.6
16	2011	May	64.9	59.4	763681	698664	65017	8.5
16	2011	Jun	64.9	59.4	764152	699823	64329	8.4
16	2011	Jul	64.9	59.5	764838	701287	63551	8.3
16	2011	Aug	64.9	59.6	765743	703015	62728	8.2
16	2011	Sep	64.9	59.6	766702	704790	61912	8.1
16	2011	Oct	64.9	59.7	767579	706444	61135	8
16	2011	Nov	64.9	59.8	768213	707813	60400	7.9
16	2011	Dec	64.8	59.8	768550	708822	59728	7.8
16	2012	Jan	64.8	59.8	768709	709573	59136	7.7
16	2012	Feb	64.7	59.8	768779	710196	58583	7.6
16	2012	Mar	64.7	59.8	768782	710756	58026	7.5
16	2012	Apr	64.6	59.8	768761	711329	57432	7.5
16	2012	May	64.6	59.8	768829	712041	56788	7.4
16	2012	Jun	64.5	59.8	769041	712968	56073	7.3
16	2012	Jul	64.5	59.9	769362	714058	55304	7.2
16	2012	Aug	64.4	59.9	769680	715187	54493	7.1
16	2012	Sep	64.4	59.9	769874	716258	53616	7
16	2012	Oct	64.3	59.9	769801	717144	52657	6.8
16	2012	Nov	64.2	59.9	769414	717778	51636	6.7
16	2012	Dec	64.1	59.9	768790	718199	50591	6.6
16	2013	Jan	64.1	59.8	770127	718500	51627	6.7
16	2013	Feb	64	59.8	769533	718847	50686	6.6
16	2013	Mar	63.9	59.8	769256	719405	49851	6.5
16	2013	Apr	63.9	59.8	769331	720215	49116	6.4
16	2013	May	63.8	59.8	769668	721176	48492	6.3
16	2013	Jun	63.8	59.8	770199	722261	47938	6.2
16	2013	Jul	63.8	59.9	770775	723471	47304	6.1
16	2013	Aug	63.8	59.9	771321	724848	46473	6
16	2013	Sep	63.7	60	771895	726443	45452	5.9
16	2013	Oct	63.7	60	772545	728225	44320	5.7
16	2013	Nov	63.7	60.1	773304	730153	43151	5.6
16	2013	Dec	63.7	60.2	774133	732112	42021	5.4
16	2014	Jan	63.7	60.3	775854	734520	41334	5.3
16	2014	Feb	63.7	60.4	776782	736276	40506	5.2
16	2014	Mar	63.7	60.5	777573	737847	39726	5.1
16	2014	Apr	63.7	60.5	778228	739220	39008	5
16	2014	May	63.7	60.5	778783	740449	38334	4.9
16	2014	Jun	63.6	60.6	779297	741596	37701	4.8
16	2014	Jul	63.6	60.6	779834	742723	37111	4.8
16	2014	Aug	63.6	60.6	780526	743953	36573	4.7
16	2014	Sep	63.6	60.6	781459	745361	36098	4.6
16	2014	Oct	63.6	60.7	782667	746985	35682	4.6
16	2014	Nov	63.6	60.7	784103	748782	35321	4.5
16	2014	Dec	63.7	60.8	785742	750711	35031	4.5
16	2015	Jan	63.5	60.9	785111	752510	32601	4.2
16	2015	Feb	63.6	61	787185	754504	32681	4.2
16	2015	Mar	63.7	61.1	789169	756429	32740	4.1
16	2015	Apr	63.8	61.1	791024	758258	32766	4.1
16	2015	May	63.8	61.2	792745	759981	32764	4.1
16	2015	Jun	63.9	61.2	794299	761564	32735	4.1
16	2015	Jul	63.9	61.3	795741	763048	32693	4.1
16	2015	Aug	63.9	61.3	797114	764468	32646	4.1
16	2015	Sep	63.9	61.3	798498	765926	32572	4.1
16	2015	Oct	63.9	61.3	800030	767573	32457	4.1
16	2015	Nov	63.9	61.3	801806	769491	32315	4
16	2015	Dec	63.9	61.4	803771	771627	32144	4
16	2016	Jan	64	61.4	805747	773795	31952	4
16	2016	Feb	64	61.5	807602	775843	31759	3.9
16	2016	Mar	64	61.5	809281	777715	31566	3.9
16	2016	Apr	64	61.5	810859	779465	31394	3.9
16	2016	May	64	61.6	812420	781168	31252	3.8
16	2016	Jun	64	61.6	814052	782932	31120	3.8
16	2016	Jul	64	61.6	815730	784782	30948	3.8
16	2016	Aug	64	61.6	817380	786677	30703	3.8
16	2016	Sep	64	61.6	818907	788528	30379	3.7
16	2016	Oct	64	61.6	820248	790265	29983	3.7
16	2016	Nov	63.9	61.6	821434	791916	29518	3.6
16	2016	Dec	63.9	61.6	822574	793562	29012	3.5
16	2017	Jan	63.9	61.7	823861	795361	28500	3.5
16	2017	Feb	63.9	61.7	825364	797354	28010	3.4
16	2017	Mar	63.9	61.7	827000	799434	27566	3.3
16	2017	Apr	63.9	61.8	828758	801577	27181	3.3
16	2017	May	63.9	61.8	830629	803777	26852	3.2
16	2017	Jun	63.9	61.9	832598	806006	26592	3.2
16	2017	Jul	63.9	61.9	834646	808241	26405	3.2
16	2017	Aug	64	62	836725	810455	26270	3.1
16	2017	Sep	64	62	838806	812653	26153	3.1
16	2017	Oct	64	62.1	840861	814841	26020	3.1
16	2017	Nov	64.1	62.1	842850	816978	25872	3.1
16	2017	Dec	64.1	62.1	844790	819073	25717	3
16	2018	Jan	64.1	62.2	846687	821121	25566	3
16	2018	Feb	64.1	62.2	848612	823187	25425	3
16	2018	Mar	64.2	62.3	850622	825346	25276	3
16	2018	Apr	64.2	62.3	852551	827456	25095	2.9
16	2018	May	64.2	62.3	854298	829419	24879	2.9
16	2018	Jun	64.2	62.4	855962	831309	24653	2.9
16	2018	Jul	64.2	62.4	857660	833198	24462	2.9
16	2018	Aug	64.2	62.4	859529	835142	24387	2.8
16	2018	Sep	64.2	62.4	861621	837146	24475	2.8
16	2018	Oct	64.3	62.4	863878	839163	24715	2.9
16	2018	Nov	64.3	62.4	866195	841160	25035	2.9
16	2018	Dec	64.3	62.5	868468	843121	25347	2.9
16	2019	Jan	64.4	62.5	870617	845034	25583	2.9
16	2019	Feb	64.4	62.5	872623	846902	25721	2.9
16	2019	Mar	64.4	62.5	874607	848811	25796	2.9
16	2019	Apr	64.4	62.5	876762	850921	25841	2.9
16	2019	May	64.5	62.6	879122	853250	25872	2.9
16	2019	Jun	64.5	62.6	881507	855620	25887	2.9
16	2019	Jul	64.6	62.7	883977	858125	25852	2.9
16	2019	Aug	64.6	62.7	886093	860354	25739	2.9
16	2019	Sep	64.6	62.7	887795	862222	25573	2.9
16	2019	Oct	64.5	62.7	888897	863475	25422	2.9
16	2019	Nov	64.4	62.5	888878	863501	25377	2.9
16	2019	Dec	64.2	62.4	888658	863269	25389	2.9
16	2020	Jan	64.2	62.4	890069	865321	24748	2.8
16	2020	Feb	64.2	62.5	891650	867808	23842	2.7
17	2010	Jan	66.9	59.3	6629263	5879062	750201	11.3
17	2010	Feb	67	59.5	6646430	5898678	747752	11.3
17	2010	Mar	67.1	59.7	6655359	5917703	737656	11.1
17	2010	Apr	67.3	60	6654739	5932888	721851	10.8
17	2010	May	67.2	60.1	6645625	5943454	702171	10.6
17	2010	Jun	67.1	60.1	6631747	5948816	682931	10.3
17	2010	Jul	66.9	60.1	6618603	5950375	668228	10.1
17	2010	Aug	66.8	60.1	6609418	5950971	658447	10
17	2010	Sep	66.6	60.1	6603128	5951512	651616	9.9
17	2010	Oct	66.6	60	6598069	5952925	645144	9.8
17	2010	Nov	66.5	60	6591482	5954456	637026	9.7
17	2010	Dec	66.3	60	6582389	5954441	627948	9.5
17	2011	Jan	66.2	60	6573539	5952822	620717	9.4
17	2011	Feb	66.1	59.9	6566762	5949580	617182	9.4
17	2011	Mar	66.1	59.8	6562927	5944798	618129	9.4
17	2011	Apr	66	59.8	6563289	5938760	624529	9.5
17	2011	May	66.1	59.7	6569329	5933281	636048	9.7
17	2011	Jun	66.1	59.6	6579893	5930717	649176	9.9
17	2011	Jul	66.2	59.6	6592480	5932875	659605	10
17	2011	Aug	66.3	59.7	6603943	5939511	664432	10.1
17	2011	Sep	66.4	59.7	6610989	5949295	661694	10
17	2011	Oct	66.3	59.8	6611838	5960203	651635	9.9
17	2011	Nov	66.3	59.9	6605805	5969807	635998	9.6
17	2011	Dec	66.1	59.9	6594308	5976406	617902	9.4
17	2012	Jan	66	59.9	6581090	5979812	601278	9.1
17	2012	Feb	65.9	59.9	6571177	5981308	589869	9
17	2012	Mar	65.8	59.9	6567040	5981313	585727	8.9
17	2012	Apr	65.8	59.9	6567372	5980357	587015	8.9
17	2012	May	65.8	59.9	6571517	5980993	590524	9
17	2012	Jun	65.8	59.9	6577714	5984744	592970	9
17	2012	Jul	65.9	60	6584040	5991553	592487	9
17	2012	Aug	65.9	60	6590143	5999586	590557	9
17	2012	Sep	65.9	60	6596052	6006010	590042	8.9
17	2012	Oct	66	60	6599251	6007289	591962	9
17	2012	Nov	65.9	60	6597998	6001762	596236	9
17	2012	Dec	65.8	59.8	6592027	5990669	601358	9.1
17	2013	Jan	65.7	59.7	6582499	5976602	605897	9.2
17	2013	Feb	65.6	59.5	6571939	5963501	608438	9.3
17	2013	Mar	65.5	59.4	6563015	5955200	607815	9.3
17	2013	Apr	65.5	59.4	6558406	5953676	604730	9.2
17	2013	May	65.4	59.4	6556908	5955695	601213	9.2
17	2013	Jun	65.4	59.4	6556074	5957303	598771	9.1
17	2013	Jul	65.3	59.4	6553792	5956577	597215	9.1
17	2013	Aug	65.3	59.4	6547571	5954206	593365	9.1
17	2013	Sep	65.2	59.3	6538493	5952790	585703	9
17	2013	Oct	65.1	59.3	6531285	5955019	576266	8.8
17	2013	Nov	65	59.4	6529007	5962789	566218	8.7
17	2013	Dec	65	59.5	6530529	5975241	555288	8.5
17	2014	Jan	65.1	59.7	6535431	5993052	542379	8.3
17	2014	Feb	65.1	59.8	6534756	6007828	526928	8.1
17	2014	Mar	65	59.9	6530889	6020562	510327	7.8
17	2014	Apr	64.9	60	6523322	6029722	493600	7.6
17	2014	May	64.8	60.1	6514281	6037402	476879	7.3
17	2014	Jun	64.8	60.2	6507901	6046821	461080	7.1
17	2014	Jul	64.7	60.3	6505054	6057874	447180	6.9
17	2014	Aug	64.7	60.4	6505576	6069687	435889	6.7
17	2014	Sep	64.7	60.5	6507158	6080707	426451	6.6
17	2014	Oct	64.7	60.6	6505589	6088861	416728	6.4
17	2014	Nov	64.6	60.6	6498925	6092601	406324	6.3
17	2014	Dec	64.5	60.6	6490580	6093224	397356	6.1
17	2015	Jan	64.4	60.5	6479540	6088283	391257	6
17	2015	Feb	64.4	60.6	6478614	6089834	388780	6
17	2015	Mar	64.5	60.6	6483485	6094889	388596	6
17	2015	Apr	64.6	60.7	6492377	6103447	388930	6
17	2015	May	64.7	60.8	6501191	6112982	388209	6
17	2015	Jun	64.7	60.9	6506555	6120533	386022	5.9
17	2015	Jul	64.7	60.9	6508842	6125365	383477	5.9
17	2015	Aug	64.8	61	6510127	6128163	381964	5.9
17	2015	Sep	64.8	61	6512908	6130997	381911	5.9
17	2015	Oct	64.9	61	6520952	6136825	384127	5.9
17	2015	Nov	65	61.1	6535516	6146369	389147	6
17	2015	Dec	65.2	61.3	6552831	6157544	395287	6
17	2016	Jan	65.3	61.4	6567794	6167588	400206	6.1
17	2016	Feb	65.4	61.4	6576715	6174341	402374	6.1
17	2016	Mar	65.5	61.5	6577603	6176953	400650	6.1
17	2016	Apr	65.4	61.5	6571787	6175766	396021	6
17	2016	May	65.3	61.4	6562522	6172165	390357	5.9
17	2016	Jun	65.2	61.4	6551737	6167321	384416	5.9
17	2016	Jul	65.1	61.3	6540568	6162291	378277	5.8
17	2016	Aug	65	61.3	6530343	6157339	373004	5.7
17	2016	Sep	64.9	61.2	6521502	6152224	369278	5.7
17	2016	Oct	64.8	61.2	6512450	6147124	365326	5.6
17	2016	Nov	64.7	61.1	6502562	6143598	358964	5.5
17	2016	Dec	64.6	61.1	6492891	6142661	350230	5.4
17	2017	Jan	64.5	61.2	6484711	6143987	340724	5.3
17	2017	Feb	64.5	61.2	6478255	6146694	331561	5.1
17	2017	Mar	64.5	61.2	6473705	6149056	324649	5
17	2017	Apr	64.4	61.3	6472076	6151235	320841	5
17	2017	May	64.5	61.3	6473346	6153887	319459	4.9
17	2017	Jun	64.5	61.3	6476716	6156853	319863	4.9
17	2017	Jul	64.6	61.4	6481304	6160307	320997	5
17	2017	Aug	64.6	61.4	6484128	6163798	320330	4.9
17	2017	Sep	64.6	61.4	6483625	6167026	316599	4.9
17	2017	Oct	64.6	61.5	6480390	6169955	310435	4.8
17	2017	Nov	64.5	61.5	6474985	6172027	302958	4.7
17	2017	Dec	64.5	61.5	6468743	6173887	294856	4.6
17	2018	Jan	64.4	61.6	6464113	6176211	287902	4.5
17	2018	Feb	64.5	61.6	6463085	6179396	283689	4.4
17	2018	Mar	64.5	61.7	6464625	6182845	281780	4.4
17	2018	Apr	64.5	61.7	6465232	6184640	280592	4.3
17	2018	May	64.5	61.7	6463579	6184058	279521	4.3
17	2018	Jun	64.5	61.7	6460591	6182634	277957	4.3
17	2018	Jul	64.5	61.7	6457531	6181715	275816	4.3
17	2018	Aug	64.5	61.7	6457071	6182617	274454	4.3
17	2018	Sep	64.5	61.8	6460176	6185692	274484	4.2
17	2018	Oct	64.6	61.8	6465769	6189695	276074	4.3
17	2018	Nov	64.6	61.8	6472201	6193166	279035	4.3
17	2018	Dec	64.7	61.9	6476504	6194343	282161	4.4
17	2019	Jan	64.7	61.9	6475751	6192440	283311	4.4
17	2019	Feb	64.6	61.8	6469321	6188045	281276	4.3
17	2019	Mar	64.6	61.8	6460202	6183400	276802	4.3
17	2019	Apr	64.5	61.8	6452156	6181182	270974	4.2
17	2019	May	64.5	61.8	6447045	6182433	264612	4.1
17	2019	Jun	64.5	61.9	6445179	6186736	258443	4
17	2019	Jul	64.5	61.9	6444841	6192675	252166	3.9
17	2019	Aug	64.4	62	6442858	6197008	245850	3.8
17	2019	Sep	64.4	62	6439731	6199414	240317	3.7
17	2019	Oct	64.4	62	6435480	6199272	236208	3.7
17	2019	Nov	64.4	62	6433159	6197576	235583	3.7
17	2019	Dec	64.4	62	6433027	6196809	236218	3.7
17	2020	Jan	64.2	61.9	6417226	6189437	227789	3.5
17	2020	Feb	64.1	61.9	6398842	6180025	218817	3.4
18	2010	Jan	64.3	57.2	3166341	2819597	346744	11
18	2010	Feb	64.4	57.3	3174143	2825320	348823	11
18	2010	Mar	64.5	57.5	3181033	2832872	348161	10.9
18	2010	Apr	64.2	57.2	3185758	2840912	344846	10.8
18	2010	May	64.2	57.4	3187271	2848122	339149	10.6
18	2010	Jun	64.1	57.4	3185465	2852903	332562	10.4
18	2010	Jul	64	57.4	3181242	2854586	326656	10.3
18	2010	Aug	63.8	57.4	3176046	2854268	321778	10.1
18	2010	Sep	63.7	57.3	3170732	2853388	317344	10
18	2010	Oct	63.6	57.3	3166143	2853952	312191	9.9
18	2010	Nov	63.5	57.3	3162275	2856852	305423	9.7
18	2010	Dec	63.4	57.4	3159427	2862029	297398	9.4
18	2011	Jan	63.3	57.5	3158887	2869164	289723	9.2
18	2011	Feb	63.3	57.6	3160522	2876584	283938	9
18	2011	Mar	63.4	57.7	3163109	2882053	281056	8.9
18	2011	Apr	63.4	57.7	3166405	2884769	281636	8.9
18	2011	May	63.5	57.7	3171288	2885793	285495	9
18	2011	Jun	63.6	57.7	3177867	2886780	291087	9.2
18	2011	Jul	63.7	57.7	3185643	2889288	296355	9.3
18	2011	Aug	63.8	57.8	3193257	2893693	299564	9.4
18	2011	Sep	63.9	57.9	3199028	2899629	299399	9.4
18	2011	Oct	63.9	58	3202015	2906222	295793	9.2
18	2011	Nov	63.8	58.1	3201209	2911729	289480	9
18	2011	Dec	63.7	58.1	3196276	2914603	281673	8.8
18	2012	Jan	63.5	58.1	3188316	2914437	273879	8.6
18	2012	Feb	63.3	58	3179585	2911957	267628	8.4
18	2012	Mar	63.2	57.9	3171742	2907822	263920	8.3
18	2012	Apr	63	57.8	3165417	2902880	262537	8.3
18	2012	May	62.9	57.7	3161347	2898841	262506	8.3
18	2012	Jun	62.8	57.6	3159779	2897215	262564	8.3
18	2012	Jul	62.8	57.6	3160387	2898371	262016	8.3
18	2012	Aug	62.8	57.6	3163069	2901505	261564	8.3
18	2012	Sep	62.9	57.7	3167606	2905442	262164	8.3
18	2012	Oct	62.9	57.7	3172520	2908732	263788	8.3
18	2012	Nov	63	57.7	3176648	2910893	265755	8.4
18	2012	Dec	63	57.7	3179250	2912145	267105	8.4
18	2013	Jan	63	57.7	3182174	2912845	269329	8.5
18	2013	Feb	63	57.7	3181912	2914139	267773	8.4
18	2013	Mar	63	57.7	3181709	2917519	264190	8.3
18	2013	Apr	63	57.8	3182826	2923774	259052	8.1
18	2013	May	63	58	3184914	2931401	253513	8
18	2013	Jun	63	58.1	3187584	2939083	248501	7.8
18	2013	Jul	63	58.2	3190762	2946803	243959	7.6
18	2013	Aug	63	58.3	3192815	2954613	238202	7.5
18	2013	Sep	63	58.4	3192847	2962355	230492	7.2
18	2013	Oct	62.9	58.5	3192201	2970053	222148	7
18	2013	Nov	62.9	58.7	3192528	2978018	214510	6.7
18	2013	Dec	62.9	58.8	3194641	2986237	208404	6.5
18	2014	Jan	63	59	3199151	2994670	204481	6.4
18	2014	Feb	63	59.1	3203824	3002769	201055	6.3
18	2014	Mar	63.1	59.2	3209321	3010315	199006	6.2
18	2014	Apr	63.2	59.3	3214399	3016674	197725	6.2
18	2014	May	63.3	59.4	3218745	3022683	196062	6.1
18	2014	Jun	63.3	59.5	3222954	3029273	193681	6
18	2014	Jul	63.4	59.6	3226932	3035963	190969	5.9
18	2014	Aug	63.4	59.7	3231964	3043026	188938	5.8
18	2014	Sep	63.5	59.8	3238381	3050622	187759	5.8
18	2014	Oct	63.6	60	3244080	3057914	186166	5.7
18	2014	Nov	63.6	60	3247234	3063870	183364	5.6
18	2014	Dec	63.6	60.1	3248080	3068507	179573	5.5
18	2015	Jan	63.6	60.2	3247783	3072369	175414	5.4
18	2015	Feb	63.6	60.3	3247936	3076733	171203	5.3
18	2015	Mar	63.6	60.4	3249304	3082274	167030	5.1
18	2015	Apr	63.7	60.5	3252270	3089276	162994	5
18	2015	May	63.7	60.6	3256167	3096985	159182	4.9
18	2015	Jun	63.8	60.7	3259977	3104396	155581	4.8
18	2015	Jul	63.8	60.8	3263980	3111489	152491	4.7
18	2015	Aug	63.9	60.9	3268583	3118417	150166	4.6
18	2015	Sep	63.9	61	3274389	3125757	148632	4.5
18	2015	Oct	64.1	61.2	3283084	3134656	148428	4.5
18	2015	Nov	64.3	61.4	3295081	3145123	149958	4.6
18	2015	Dec	64.5	61.5	3308421	3155917	152504	4.6
18	2016	Jan	64.7	61.7	3320240	3165306	154934	4.7
18	2016	Feb	64.8	61.8	3328783	3172241	156542	4.7
18	2016	Mar	64.9	61.9	3333489	3176736	156753	4.7
18	2016	Apr	64.9	61.9	3335181	3179546	155635	4.7
18	2016	May	64.9	61.9	3335255	3181697	153558	4.6
18	2016	Jun	64.8	61.9	3334355	3183653	150702	4.5
18	2016	Jul	64.7	61.9	3332623	3185360	147263	4.4
18	2016	Aug	64.7	61.9	3330464	3186486	143978	4.3
18	2016	Sep	64.6	61.9	3328358	3186749	141609	4.3
18	2016	Oct	64.5	61.8	3325869	3186208	139661	4.2
18	2016	Nov	64.4	61.8	3323069	3186061	137008	4.1
18	2016	Dec	64.4	61.8	3320863	3187493	133370	4
18	2017	Jan	64.3	61.8	3320158	3191055	129103	3.9
18	2017	Feb	64.3	61.9	3320973	3196536	124437	3.7
18	2017	Mar	64.3	62	3322744	3202420	120324	3.6
18	2017	Apr	64.4	62.1	3325547	3207896	117651	3.5
18	2017	May	64.4	62.1	3329235	3212573	116662	3.5
18	2017	Jun	64.5	62.2	3333454	3216178	117276	3.5
18	2017	Jul	64.5	62.2	3337942	3219150	118792	3.6
18	2017	Aug	64.5	62.2	3341454	3221814	119640	3.6
18	2017	Sep	64.5	62.2	3343190	3224415	118775	3.6
18	2017	Oct	64.5	62.2	3343693	3227318	116375	3.5
18	2017	Nov	64.5	62.3	3344001	3230467	113534	3.4
18	2017	Dec	64.5	62.3	3345485	3234218	111267	3.3
18	2018	Jan	64.5	62.4	3349616	3238977	110639	3.3
18	2018	Feb	64.6	62.5	3357086	3244966	112120	3.3
18	2018	Mar	64.8	62.6	3366816	3251915	114901	3.4
18	2018	Apr	64.9	62.7	3375897	3258333	117564	3.5
18	2018	May	65	62.7	3382443	3263063	119380	3.5
18	2018	Jun	65	62.7	3386296	3266249	120047	3.5
18	2018	Jul	65	62.7	3387859	3268182	119677	3.5
18	2018	Aug	65	62.7	3389067	3269817	119250	3.5
18	2018	Sep	65	62.7	3391666	3272316	119350	3.5
18	2018	Oct	65	62.7	3395964	3275878	120086	3.5
18	2018	Nov	65.1	62.8	3401009	3279775	121234	3.6
18	2018	Dec	65.1	62.8	3404551	3282427	122124	3.6
18	2019	Jan	65.1	62.8	3404310	3282340	121970	3.6
18	2019	Feb	65	62.7	3399291	3278775	120516	3.5
18	2019	Mar	64.8	62.5	3391039	3272809	118230	3.5
18	2019	Apr	64.6	62.4	3382499	3266910	115589	3.4
18	2019	May	64.4	62.3	3376225	3263234	112991	3.3
18	2019	Jun	64.3	62.2	3373873	3263061	110812	3.3
18	2019	Jul	64.3	62.3	3376195	3266943	109252	3.2
18	2019	Aug	64.4	62.3	3380901	3272718	108183	3.2
18	2019	Sep	64.4	62.4	3386110	3278500	107610	3.2
18	2019	Oct	64.5	62.4	3389444	3282061	107383	3.2
18	2019	Nov	64.4	62.4	3389478	3281975	107503	3.2
18	2019	Dec	64.4	62.3	3388859	3281209	107650	3.2
18	2020	Jan	64.4	62.4	3392922	3286146	106776	3.1
18	2020	Feb	64.4	62.4	3396036	3290859	105177	3.1
19	2010	Jan	71.6	67.1	1677700	1571136	106564	6.4
19	2010	Feb	71.7	67.1	1678413	1572916	105497	6.3
19	2010	Mar	71.6	67.2	1678977	1574961	104016	6.2
19	2010	Apr	71.2	66.9	1679141	1576713	102428	6.1
19	2010	May	71.2	66.9	1678850	1577916	100934	6
19	2010	Jun	71.1	66.9	1678125	1578456	99669	5.9
19	2010	Jul	71	66.8	1677463	1578577	98886	5.9
19	2010	Aug	71	66.8	1677309	1578729	98580	5.9
19	2010	Sep	70.9	66.8	1677717	1579134	98583	5.9
19	2010	Oct	70.9	66.8	1678395	1579883	98512	5.9
19	2010	Nov	70.9	66.8	1678737	1580655	98082	5.8
19	2010	Dec	70.9	66.7	1678150	1580931	97219	5.8
19	2011	Jan	70.7	66.7	1676439	1580360	96079	5.7
19	2011	Feb	70.6	66.6	1673701	1578838	94863	5.7
19	2011	Mar	70.4	66.5	1670235	1576542	93693	5.6
19	2011	Apr	70.2	66.3	1666505	1573767	92738	5.6
19	2011	May	70.1	66.2	1663044	1570898	92146	5.5
19	2011	Jun	69.9	66	1660285	1568386	91899	5.5
19	2011	Jul	69.8	65.9	1658330	1566490	91840	5.5
19	2011	Aug	69.7	65.8	1657051	1565320	91731	5.5
19	2011	Sep	69.6	65.8	1656336	1564954	91382	5.5
19	2011	Oct	69.6	65.8	1656036	1565346	90690	5.5
19	2011	Nov	69.5	65.8	1655845	1566263	89582	5.4
19	2011	Dec	69.5	65.8	1655530	1567422	88108	5.3
19	2012	Jan	69.4	65.8	1655012	1568570	86442	5.2
19	2012	Feb	69.4	65.8	1654386	1569426	84960	5.1
19	2012	Mar	69.3	65.8	1653639	1569640	83999	5.1
19	2012	Apr	69.3	65.8	1652667	1569155	83512	5.1
19	2012	May	69.2	65.7	1651738	1568358	83380	5
19	2012	Jun	69.1	65.7	1651144	1567733	83411	5.1
19	2012	Jul	69.1	65.6	1651019	1567718	83301	5
19	2012	Aug	69.1	65.6	1651397	1568392	83005	5
19	2012	Sep	69.1	65.6	1652163	1569562	82601	5
19	2012	Oct	69	65.6	1653077	1570981	82096	5
19	2012	Nov	69.1	65.6	1654247	1572489	81758	4.9
19	2012	Dec	69.1	65.7	1655811	1574099	81712	4.9
19	2013	Jan	69.1	65.7	1657808	1575926	81882	4.9
19	2013	Feb	69.2	65.8	1660293	1578214	82079	4.9
19	2013	Mar	69.3	65.9	1663533	1581458	82075	4.9
19	2013	Apr	69.5	66.1	1667620	1585820	81800	4.9
19	2013	May	69.6	66.2	1671900	1590692	81208	4.9
19	2013	Jun	69.7	66.4	1675671	1595295	80376	4.8
19	2013	Jul	69.8	66.5	1678587	1599183	79404	4.7
19	2013	Aug	69.8	66.6	1680556	1602276	78280	4.7
19	2013	Sep	69.8	66.6	1681833	1604751	77082	4.6
19	2013	Oct	69.9	66.7	1682991	1606869	76122	4.5
19	2013	Nov	69.9	66.7	1684516	1609032	75484	4.5
19	2013	Dec	69.9	66.8	1686595	1611506	75089	4.5
19	2014	Jan	70.1	67	1690171	1615429	74742	4.4
19	2014	Feb	70.1	67.1	1693232	1618872	74360	4.4
19	2014	Mar	70.2	67.2	1696024	1622076	73948	4.4
19	2014	Apr	70.3	67.3	1698282	1624783	73499	4.3
19	2014	May	70.3	67.3	1700176	1627201	72975	4.3
19	2014	Jun	70.4	67.4	1701958	1629585	72373	4.3
19	2014	Jul	70.4	67.4	1703586	1631795	71791	4.2
19	2014	Aug	70.4	67.5	1705121	1633789	71332	4.2
19	2014	Sep	70.4	67.5	1706417	1635553	70864	4.2
19	2014	Oct	70.4	67.5	1707224	1637013	70211	4.1
19	2014	Nov	70.4	67.6	1707293	1638022	69271	4.1
19	2014	Dec	70.4	67.6	1706704	1638498	68206	4
19	2015	Jan	70.2	67.4	1702933	1635995	66938	3.9
19	2015	Feb	70.1	67.4	1701472	1635417	66055	3.9
19	2015	Mar	70.1	67.4	1700140	1634796	65344	3.8
19	2015	Apr	70	67.3	1698873	1634174	64699	3.8
19	2015	May	69.9	67.3	1697547	1633463	64084	3.8
19	2015	Jun	69.8	67.2	1696284	1632769	63515	3.7
19	2015	Jul	69.8	67.2	1695446	1632401	63045	3.7
19	2015	Aug	69.7	67.1	1695235	1632568	62667	3.7
19	2015	Sep	69.7	67.1	1695724	1633276	62448	3.7
19	2015	Oct	69.7	67.2	1696828	1634445	62383	3.7
19	2015	Nov	69.8	67.2	1698179	1635792	62387	3.7
19	2015	Dec	69.8	67.2	1699220	1636901	62319	3.7
19	2016	Jan	69.8	67.2	1699371	1637272	62099	3.7
19	2016	Feb	69.7	67.2	1698432	1636572	61860	3.6
19	2016	Mar	69.6	67.1	1696676	1634926	61750	3.6
19	2016	Apr	69.5	67	1694652	1632809	61843	3.6
19	2016	May	69.4	66.9	1692845	1630753	62092	3.7
19	2016	Jun	69.3	66.8	1691281	1628985	62296	3.7
19	2016	Jul	69.2	66.7	1689795	1627571	62224	3.7
19	2016	Aug	69.1	66.6	1688153	1626330	61823	3.7
19	2016	Sep	69	66.5	1686120	1624950	61170	3.6
19	2016	Oct	68.9	66.4	1683490	1623220	60270	3.6
19	2016	Nov	68.7	66.3	1680460	1621291	59169	3.5
19	2016	Dec	68.6	66.2	1677455	1619471	57984	3.5
19	2017	Jan	68.5	66.1	1674974	1618128	56846	3.4
19	2017	Feb	68.4	66.1	1673335	1617568	55767	3.3
19	2017	Mar	68.3	66.1	1672548	1617761	54787	3.3
19	2017	Apr	68.3	66.1	1672630	1618631	53999	3.2
19	2017	May	68.3	66.1	1673258	1619914	53344	3.2
19	2017	Jun	68.3	66.2	1673834	1621084	52750	3.2
19	2017	Jul	68.3	66.2	1673930	1621789	52141	3.1
19	2017	Aug	68.2	66.1	1673330	1621979	51351	3.1
19	2017	Sep	68.2	66.1	1672334	1621984	50350	3
19	2017	Oct	68.1	66.1	1671496	1622236	49260	2.9
19	2017	Nov	68.1	66.1	1671300	1623003	48297	2.9
19	2017	Dec	68.1	66.2	1672136	1624632	47504	2.8
19	2018	Jan	68.2	66.3	1674204	1627347	46857	2.8
19	2018	Feb	68.3	66.4	1677313	1630983	46330	2.8
19	2018	Mar	68.4	66.6	1680761	1634987	45774	2.7
19	2018	Apr	68.5	66.7	1683698	1638661	45037	2.7
19	2018	May	68.6	66.8	1685939	1641741	44198	2.6
19	2018	Jun	68.7	66.9	1687908	1644528	43380	2.6
19	2018	Jul	68.7	67	1690078	1647349	42729	2.5
19	2018	Aug	68.8	67.1	1692987	1650533	42454	2.5
19	2018	Sep	68.9	67.2	1696884	1654354	42530	2.5
19	2018	Oct	69.1	67.4	1701781	1658789	42992	2.5
19	2018	Nov	69.3	67.5	1707325	1663548	43777	2.6
19	2018	Dec	69.5	67.7	1712768	1668076	44692	2.6
19	2019	Jan	69.7	67.9	1717459	1671886	45573	2.7
19	2019	Feb	69.8	68	1721176	1674918	46258	2.7
19	2019	Mar	70	68.1	1724319	1677562	46757	2.7
19	2019	Apr	70.1	68.2	1727448	1680404	47044	2.7
19	2019	May	70.2	68.3	1730994	1683850	47144	2.7
19	2019	Jun	70.3	68.4	1735299	1688059	47240	2.7
19	2019	Jul	70.5	68.6	1740791	1693248	47543	2.7
19	2019	Aug	70.7	68.8	1746330	1698273	48057	2.8
19	2019	Sep	70.9	68.9	1751217	1702476	48741	2.8
19	2019	Oct	71	69	1754370	1705063	49307	2.8
19	2019	Nov	71	69	1754287	1704890	49397	2.8
19	2019	Dec	70.9	68.9	1753614	1704276	49338	2.8
19	2020	Jan	71	68.9	1754704	1704978	49726	2.8
19	2020	Feb	70.9	68.9	1752764	1703503	49261	2.8
20	2010	Jan	70.4	65.3	1506003	1397325	108678	7.2
20	2010	Feb	70.3	65.3	1504661	1396164	108497	7.2
20	2010	Mar	70.2	65.2	1503545	1395688	107857	7.2
20	2010	Apr	70	65	1502629	1395747	106882	7.1
20	2010	May	69.9	65	1501761	1396071	105690	7
20	2010	Jun	69.8	65	1500929	1396182	104747	7
20	2010	Jul	69.8	64.9	1500087	1395787	104300	7
20	2010	Aug	69.7	64.8	1499249	1394978	104271	7
20	2010	Sep	69.6	64.8	1498527	1393989	104538	7
20	2010	Oct	69.6	64.7	1498125	1393254	104871	7
20	2010	Nov	69.5	64.6	1497897	1392963	104934	7
20	2010	Dec	69.5	64.6	1497590	1393039	104551	7
20	2011	Jan	69.4	64.6	1497002	1393260	103742	6.9
20	2011	Feb	69.3	64.6	1495829	1393342	102487	6.9
20	2011	Mar	69.2	64.6	1494025	1393176	100849	6.8
20	2011	Apr	69.1	64.5	1491929	1392856	99073	6.6
20	2011	May	69	64.5	1490149	1392637	97512	6.5
20	2011	Jun	68.9	64.5	1489125	1392802	96323	6.5
20	2011	Jul	68.9	64.5	1488961	1393396	95565	6.4
20	2011	Aug	68.9	64.5	1489304	1394198	95106	6.4
20	2011	Sep	68.8	64.5	1489593	1395030	94563	6.3
20	2011	Oct	68.8	64.5	1489501	1395785	93716	6.3
20	2011	Nov	68.7	64.4	1488863	1396313	92550	6.2
20	2011	Dec	68.6	64.4	1487729	1396598	91131	6.1
20	2012	Jan	68.6	64.4	1486440	1396822	89618	6
20	2012	Feb	68.5	64.4	1485381	1397111	88270	5.9
20	2012	Mar	68.4	64.4	1484558	1397295	87263	5.9
20	2012	Apr	68.3	64.4	1483742	1397324	86418	5.8
20	2012	May	68.3	64.3	1483049	1397448	85601	5.8
20	2012	Jun	68.2	64.3	1482687	1397941	84746	5.7
20	2012	Jul	68.2	64.3	1482906	1399007	83899	5.7
20	2012	Aug	68.2	64.4	1483901	1400598	83303	5.6
20	2012	Sep	68.3	64.4	1485494	1402370	83124	5.6
20	2012	Oct	68.3	64.5	1487079	1403867	83212	5.6
20	2012	Nov	68.3	64.5	1488233	1404914	83319	5.6
20	2012	Dec	68.3	64.5	1488770	1405512	83258	5.6
20	2013	Jan	68.2	64.4	1486639	1403681	82958	5.6
20	2013	Feb	68.2	64.4	1486147	1403748	82399	5.5
20	2013	Mar	68.2	64.4	1485814	1404095	81719	5.5
20	2013	Apr	68.2	64.4	1485983	1404882	81101	5.5
20	2013	May	68.2	64.5	1486465	1405879	80586	5.4
20	2013	Jun	68.2	64.5	1486898	1406811	80087	5.4
20	2013	Jul	68.1	64.5	1487012	1407581	79431	5.3
20	2013	Aug	68.1	64.5	1486564	1408273	78291	5.3
20	2013	Sep	68	64.5	1485783	1409064	76719	5.2
20	2013	Oct	67.9	64.5	1485261	1410137	75124	5.1
20	2013	Nov	67.9	64.6	1485381	1411634	73747	5
20	2013	Dec	67.9	64.6	1486214	1413550	72664	4.9
20	2014	Jan	68	64.7	1488043	1416150	71893	4.8
20	2014	Feb	68.1	64.8	1489871	1418675	71196	4.8
20	2014	Mar	68.1	64.9	1491593	1421049	70544	4.7
20	2014	Apr	68.1	65	1492829	1422972	69857	4.7
20	2014	May	68.1	65	1493466	1424414	69052	4.6
20	2014	Jun	68.1	65	1493654	1425540	68114	4.6
20	2014	Jul	68.1	65	1493478	1426371	67107	4.5
20	2014	Aug	68	65	1493171	1426989	66182	4.4
20	2014	Sep	68	65	1492868	1427472	65396	4.4
20	2014	Oct	67.9	65	1492506	1427819	64687	4.3
20	2014	Nov	67.9	65	1492119	1427910	64209	4.3
20	2014	Dec	67.9	64.9	1491875	1427726	64149	4.3
20	2015	Jan	67.8	64.9	1490808	1426366	64442	4.3
20	2015	Feb	67.8	64.8	1490773	1425872	64901	4.4
20	2015	Mar	67.7	64.8	1490715	1425529	65186	4.4
20	2015	Apr	67.7	64.8	1490525	1425527	64998	4.4
20	2015	May	67.7	64.8	1490082	1425859	64223	4.3
20	2015	Jun	67.6	64.8	1489406	1426405	63001	4.2
20	2015	Jul	67.6	64.8	1488716	1427093	61623	4.1
20	2015	Aug	67.5	64.8	1488253	1427873	60380	4.1
20	2015	Sep	67.5	64.8	1488145	1428706	59439	4
20	2015	Oct	67.5	64.8	1488474	1429538	58936	4
20	2015	Nov	67.5	64.8	1489091	1430260	58831	4
20	2015	Dec	67.5	64.8	1489544	1430695	58849	4
20	2016	Jan	67.4	64.8	1489470	1430646	58824	3.9
20	2016	Feb	67.4	64.7	1488767	1429984	58783	3.9
20	2016	Mar	67.3	64.6	1487516	1428684	58832	4
20	2016	Apr	67.2	64.5	1485963	1426864	59099	4
20	2016	May	67.1	64.4	1484466	1424843	59623	4
20	2016	Jun	67	64.3	1483235	1422937	60298	4.1
20	2016	Jul	67	64.2	1482348	1421415	60933	4.1
20	2016	Aug	66.9	64.2	1481715	1420364	61351	4.1
20	2016	Sep	66.9	64.1	1481156	1419734	61422	4.1
20	2016	Oct	66.8	64.1	1480456	1419511	60945	4.1
20	2016	Nov	66.8	64.1	1479556	1419671	59885	4
20	2016	Dec	66.7	64.1	1478564	1420053	58511	4
20	2017	Jan	66.7	64.1	1477592	1420459	57133	3.9
20	2017	Feb	66.7	64.1	1476730	1420853	55877	3.8
20	2017	Mar	66.6	64.2	1476127	1421191	54936	3.7
20	2017	Apr	66.6	64.2	1475989	1421563	54426	3.7
20	2017	May	66.6	64.2	1476241	1422035	54206	3.7
20	2017	Jun	66.7	64.2	1476626	1422543	54083	3.7
20	2017	Jul	66.7	64.2	1476897	1422992	53905	3.6
20	2017	Aug	66.6	64.2	1476793	1423257	53536	3.6
20	2017	Sep	66.6	64.2	1476276	1423318	52958	3.6
20	2017	Oct	66.5	64.2	1475509	1423215	52294	3.5
20	2017	Nov	66.5	64.2	1474727	1423062	51665	3.5
20	2017	Dec	66.4	64.1	1474241	1423163	51078	3.5
20	2018	Jan	66.4	64.2	1474306	1423709	50597	3.4
20	2018	Feb	66.5	64.2	1474952	1424710	50242	3.4
20	2018	Mar	66.5	64.2	1475864	1426026	49838	3.4
20	2018	Apr	66.5	64.3	1476613	1427356	49257	3.3
20	2018	May	66.5	64.3	1477087	1428461	48626	3.3
20	2018	Jun	66.5	64.4	1477419	1429382	48037	3.3
20	2018	Jul	66.5	64.4	1477726	1430171	47555	3.2
20	2018	Aug	66.5	64.4	1478246	1430900	47346	3.2
20	2018	Sep	66.5	64.4	1479031	1431594	47437	3.2
20	2018	Oct	66.5	64.4	1479965	1432197	47768	3.2
20	2018	Nov	66.5	64.4	1480850	1432676	48174	3.3
20	2018	Dec	66.6	64.4	1481477	1433006	48471	3.3
20	2019	Jan	66.6	64.4	1481778	1433280	48498	3.3
20	2019	Feb	66.6	64.4	1481810	1433605	48205	3.3
20	2019	Mar	66.6	64.4	1481866	1434149	47717	3.2
20	2019	Apr	66.6	64.4	1482224	1435111	47113	3.2
20	2019	May	66.6	64.5	1482972	1436489	46483	3.1
20	2019	Jun	66.6	64.5	1484145	1438114	46031	3.1
20	2019	Jul	66.7	64.6	1486033	1440113	45920	3.1
20	2019	Aug	66.7	64.7	1488057	1441976	46081	3.1
20	2019	Sep	66.8	64.7	1490123	1443702	46421	3.1
20	2019	Oct	66.8	64.7	1491710	1444930	46780	3.1
20	2019	Nov	66.8	64.7	1491949	1445043	46906	3.1
20	2019	Dec	66.8	64.7	1491808	1444886	46922	3.1
20	2020	Jan	66.9	64.8	1493934	1447063	46871	3.1
20	2020	Feb	67	64.9	1496507	1449693	46814	3.1
21	2010	Jan	61.4	54.9	2053600	1835448	218152	10.6
21	2010	Feb	61.4	54.9	2054417	1836904	217513	10.6
21	2010	Mar	61.4	54.9	2054433	1839003	215430	10.5
21	2010	Apr	61.5	55.1	2053563	1841330	212233	10.3
21	2010	May	61.4	55.1	2052134	1843647	208487	10.2
21	2010	Jun	61.3	55.1	2050773	1845449	205324	10
21	2010	Jul	61.2	55.1	2050339	1846533	203806	9.9
21	2010	Aug	61.2	55.1	2051438	1847365	204073	9.9
21	2010	Sep	61.2	55.1	2053705	1848429	205276	10
21	2010	Oct	61.3	55.1	2056574	1850281	206293	10
21	2010	Nov	61.3	55.2	2059204	1852855	206349	10
21	2010	Dec	61.3	55.2	2060696	1855585	205111	10
21	2011	Jan	61.3	55.3	2060919	1858039	202880	9.8
21	2011	Feb	61.3	55.3	2059995	1859617	200378	9.7
21	2011	Mar	61.2	55.3	2058006	1859950	198056	9.6
21	2011	Apr	61.1	55.2	2055557	1859186	196371	9.6
21	2011	May	61	55.2	2053682	1858070	195612	9.5
21	2011	Jun	60.9	55.1	2052956	1857634	195322	9.5
21	2011	Jul	60.9	55.1	2053577	1858686	194891	9.5
21	2011	Aug	60.9	55.2	2055093	1861265	193828	9.4
21	2011	Sep	60.9	55.3	2056518	1864979	191539	9.3
21	2011	Oct	60.9	55.4	2057166	1869247	187919	9.1
21	2011	Nov	60.9	55.5	2056412	1873315	183097	8.9
21	2011	Dec	60.8	55.5	2054227	1876666	177561	8.6
21	2012	Jan	60.7	55.6	2051531	1879304	172227	8.4
21	2012	Feb	60.6	55.6	2049670	1881633	168037	8.2
21	2012	Mar	60.6	55.7	2049449	1883676	165773	8.1
21	2012	Apr	60.6	55.7	2050796	1885257	165539	8.1
21	2012	May	60.7	55.7	2053571	1886909	166662	8.1
21	2012	Jun	60.8	55.8	2057239	1889104	168135	8.2
21	2012	Jul	60.8	55.8	2061007	1891934	169073	8.2
21	2012	Aug	60.9	55.9	2064542	1895210	169332	8.2
21	2012	Sep	60.9	56	2067604	1898510	169094	8.2
21	2012	Oct	61	56	2069503	1901055	168448	8.1
21	2012	Nov	60.9	56	2070146	1902389	167757	8.1
21	2012	Dec	60.9	56	2069797	1902547	167250	8.1
21	2013	Jan	60.8	55.9	2068663	1901562	167101	8.1
21	2013	Feb	60.8	55.8	2067151	1899823	167328	8.1
21	2013	Mar	60.7	55.8	2065749	1898143	167606	8.1
21	2013	Apr	60.6	55.7	2064835	1897226	167609	8.1
21	2013	May	60.6	55.7	2063856	1896406	167450	8.1
21	2013	Jun	60.5	55.6	2062221	1894931	167290	8.1
21	2013	Jul	60.4	55.5	2059502	1892618	166884	8.1
21	2013	Aug	60.2	55.4	2055073	1889503	165570	8.1
21	2013	Sep	60	55.2	2049298	1885919	163379	8
21	2013	Oct	59.8	55.1	2043395	1882493	160902	7.9
21	2013	Nov	59.6	55	2038240	1879846	158394	7.8
21	2013	Dec	59.5	54.9	2034037	1878144	155893	7.7
21	2014	Jan	59.5	55	2032998	1879860	153138	7.5
21	2014	Feb	59.3	55	2029474	1879662	149812	7.4
21	2014	Mar	59.2	54.9	2025290	1879379	145911	7.2
21	2014	Apr	59	54.9	2019835	1878378	141457	7
21	2014	May	58.8	54.8	2013293	1876977	136316	6.8
21	2014	Jun	58.6	54.8	2006638	1875888	130750	6.5
21	2014	Jul	58.4	54.7	2000517	1875130	125387	6.3
21	2014	Aug	58.2	54.7	1995672	1874877	120795	6.1
21	2014	Sep	58.1	54.7	1992168	1875166	117002	5.9
21	2014	Oct	58	54.7	1989425	1875702	113723	5.7
21	2014	Nov	57.9	54.7	1986947	1876002	110945	5.6
21	2014	Dec	57.8	54.6	1984783	1875956	108827	5.5
21	2015	Jan	57.8	54.6	1984321	1876851	107470	5.4
21	2015	Feb	57.7	54.6	1982924	1876338	106586	5.4
21	2015	Mar	57.7	54.6	1981815	1875794	106021	5.3
21	2015	Apr	57.6	54.6	1980734	1875318	105416	5.3
21	2015	May	57.6	54.5	1979359	1874740	104619	5.3
21	2015	Jun	57.5	54.5	1977617	1873955	103662	5.2
21	2015	Jul	57.4	54.4	1976275	1873403	102872	5.2
21	2015	Aug	57.4	54.4	1976141	1873529	102612	5.2
21	2015	Sep	57.4	54.4	1977742	1874780	102962	5.2
21	2015	Oct	57.5	54.5	1981380	1877563	103817	5.2
21	2015	Nov	57.6	54.6	1986433	1881634	104799	5.3
21	2015	Dec	57.7	54.7	1991683	1886244	105439	5.3
21	2016	Jan	57.8	54.8	1996063	1890603	105460	5.3
21	2016	Feb	57.9	54.9	1999099	1894362	104737	5.2
21	2016	Mar	57.9	55	2001105	1897720	103385	5.2
21	2016	Apr	58	55	2003121	1901107	102014	5.1
21	2016	May	58	55.1	2006195	1904989	101206	5
21	2016	Jun	58.2	55.2	2010546	1909451	101095	5
21	2016	Jul	58.3	55.3	2015731	1914274	101457	5
21	2016	Aug	58.4	55.4	2021173	1918965	102208	5.1
21	2016	Sep	58.5	55.5	2026369	1923054	103315	5.1
21	2016	Oct	58.6	55.6	2030929	1926438	104491	5.1
21	2016	Nov	58.7	55.7	2035072	1929618	105454	5.2
21	2016	Dec	58.8	55.8	2039044	1933014	106030	5.2
21	2017	Jan	58.9	55.9	2042918	1936729	106189	5.2
21	2017	Feb	59	56	2046620	1940603	106017	5.2
21	2017	Mar	59.1	56	2049770	1944029	105741	5.2
21	2017	Apr	59.1	56.1	2052310	1947010	105300	5.1
21	2017	May	59.2	56.2	2054272	1949791	104481	5.1
21	2017	Jun	59.2	56.2	2055675	1952394	103281	5
21	2017	Jul	59.2	56.3	2056677	1954955	101722	4.9
21	2017	Aug	59.2	56.3	2056964	1957375	99589	4.8
21	2017	Sep	59.1	56.4	2056448	1959496	96952	4.7
21	2017	Oct	59.1	56.4	2055337	1961150	94187	4.6
21	2017	Nov	59	56.4	2053900	1962173	91727	4.5
21	2017	Dec	59	56.4	2052740	1962812	89928	4.4
21	2018	Jan	59	56.4	2052556	1963545	89011	4.3
21	2018	Feb	59	56.5	2053707	1964826	88881	4.3
21	2018	Mar	59.1	56.5	2055810	1966703	89107	4.3
21	2018	Apr	59.1	56.5	2057822	1968419	89403	4.3
21	2018	May	59.1	56.6	2058987	1969243	89744	4.4
21	2018	Jun	59.1	56.5	2059249	1969330	89919	4.4
21	2018	Jul	59.1	56.5	2058845	1969006	89839	4.4
21	2018	Aug	59.1	56.5	2058438	1968800	89638	4.4
21	2018	Sep	59	56.5	2058455	1969164	89291	4.3
21	2018	Oct	59	56.5	2058983	1970167	88816	4.3
21	2018	Nov	59	56.5	2059935	1971621	88314	4.3
21	2018	Dec	59.1	56.5	2060868	1973067	87801	4.3
21	2019	Jan	59.1	56.6	2061457	1974101	87356	4.2
21	2019	Feb	59.1	56.6	2061672	1974520	87152	4.2
21	2019	Mar	59.1	56.6	2062224	1974793	87431	4.2
21	2019	Apr	59.1	56.6	2063803	1975754	88049	4.3
21	2019	May	59.2	56.6	2066550	1977916	88634	4.3
21	2019	Jun	59.3	56.7	2070301	1981147	89154	4.3
21	2019	Jul	59.4	56.8	2074764	1985146	89618	4.3
21	2019	Aug	59.5	56.9	2078630	1988713	89917	4.3
21	2019	Sep	59.5	57	2081590	1991454	90136	4.3
21	2019	Oct	59.6	57	2083132	1992837	90295	4.3
21	2019	Nov	59.5	57	2082697	1992397	90300	4.3
21	2019	Dec	59.5	56.9	2082207	1991923	90284	4.3
21	2020	Jan	59.6	57	2084752	1994520	90232	4.3
21	2020	Feb	59.6	57	2083955	1996018	87937	4.2
22	2010	Jan	60.6	56.1	2065028	1911282	153746	7.4
22	2010	Feb	60.8	56.2	2072458	1916327	156131	7.5
22	2010	Mar	61	56.3	2080069	1921681	158388	7.6
22	2010	Apr	60.8	56.1	2086900	1926189	160711	7.7
22	2010	May	60.9	56.1	2092101	1929083	163018	7.8
22	2010	Jun	60.9	56.1	2094979	1929545	165434	7.9
22	2010	Jul	60.8	56	2095489	1927347	168142	8
22	2010	Aug	60.7	55.8	2094171	1923376	170795	8.2
22	2010	Sep	60.6	55.6	2091694	1918710	172984	8.3
22	2010	Oct	60.5	55.4	2089158	1914750	174408	8.3
22	2010	Nov	60.4	55.3	2086945	1912139	174806	8.4
22	2010	Dec	60.3	55.2	2084897	1910814	174083	8.3
22	2011	Jan	60.1	55.2	2082966	1910437	172529	8.3
22	2011	Feb	60	55.1	2080850	1910324	170526	8.2
22	2011	Mar	59.9	55.1	2078080	1909919	168161	8.1
22	2011	Apr	59.8	55	2074660	1909053	165607	8
22	2011	May	59.6	54.9	2071476	1908068	163408	7.9
22	2011	Jun	59.5	54.9	2069314	1907671	161643	7.8
22	2011	Jul	59.4	54.8	2068547	1908367	160180	7.7
22	2011	Aug	59.4	54.9	2068989	1909945	159044	7.7
22	2011	Sep	59.4	54.9	2069983	1911840	158143	7.6
22	2011	Oct	59.4	54.9	2070931	1913517	157414	7.6
22	2011	Nov	59.4	54.9	2071370	1914670	156700	7.6
22	2011	Dec	59.4	54.9	2071368	1915529	155839	7.5
22	2012	Jan	59.3	54.9	2071658	1916726	154932	7.5
22	2012	Feb	59.3	54.9	2073080	1918815	154265	7.4
22	2012	Mar	59.4	55	2075571	1921592	153979	7.4
22	2012	Apr	59.4	55	2078081	1924525	153556	7.4
22	2012	May	59.5	55.1	2079852	1927516	152336	7.3
22	2012	Jun	59.4	55.2	2080624	1930777	149847	7.2
22	2012	Jul	59.4	55.2	2080660	1934486	146174	7
22	2012	Aug	59.4	55.3	2080892	1938467	142425	6.8
22	2012	Sep	59.4	55.4	2082392	1942392	140000	6.7
22	2012	Oct	59.4	55.4	2085197	1945682	139515	6.7
22	2012	Nov	59.5	55.5	2088848	1947834	141014	6.8
22	2012	Dec	59.6	55.5	2092629	1948748	143881	6.9
22	2013	Jan	59.6	55.4	2095766	1948681	147085	7
22	2013	Feb	59.7	55.4	2097870	1948351	149519	7.1
22	2013	Mar	59.7	55.4	2099138	1948749	150389	7.2
22	2013	Apr	59.7	55.4	2100337	1950743	149594	7.1
22	2013	May	59.7	55.5	2101514	1953900	147614	7
22	2013	Jun	59.7	55.6	2102566	1957422	145144	6.9
22	2013	Jul	59.7	55.6	2103477	1960947	142530	6.8
22	2013	Aug	59.6	55.7	2103643	1964537	139106	6.6
22	2013	Sep	59.6	55.8	2102914	1968399	134515	6.4
22	2013	Oct	59.5	55.9	2102349	1972749	129600	6.2
22	2013	Nov	59.5	56	2102929	1977783	125146	6
22	2013	Dec	59.6	56.1	2104957	1983169	121788	5.8
22	2014	Jan	59.6	56.2	2106326	1986341	119985	5.7
22	2014	Feb	59.7	56.3	2111132	1991501	119631	5.7
22	2014	Mar	59.8	56.4	2117647	1996305	121342	5.7
22	2014	Apr	60	56.5	2125752	2000684	125068	5.9
22	2014	May	60.3	56.6	2135363	2005356	130007	6.1
22	2014	Jun	60.6	56.7	2146419	2010981	135438	6.3
22	2014	Jul	60.9	56.9	2158084	2017224	140860	6.5
22	2014	Aug	61.2	57	2169595	2023700	145895	6.7
22	2014	Sep	61.4	57.2	2179721	2029720	150001	6.9
22	2014	Oct	61.6	57.3	2186761	2034365	152396	7
22	2014	Nov	61.6	57.3	2189785	2036932	152853	7
22	2014	Dec	61.6	57.3	2189469	2037589	151880	6.9
22	2015	Jan	61.4	57.2	2185858	2035826	150032	6.9
22	2015	Feb	61.3	57.2	2181833	2034113	147720	6.8
22	2015	Mar	61.1	57.1	2177063	2032196	144867	6.7
22	2015	Apr	61	57	2171805	2030256	141549	6.5
22	2015	May	60.8	56.9	2166106	2027977	138129	6.4
22	2015	Jun	60.6	56.8	2159887	2024933	134954	6.2
22	2015	Jul	60.4	56.7	2153539	2021216	132323	6.1
22	2015	Aug	60.2	56.5	2147667	2017140	130527	6.1
22	2015	Sep	60	56.4	2142848	2013302	129546	6
22	2015	Oct	59.9	56.3	2139798	2010439	129359	6
22	2015	Nov	59.8	56.2	2138611	2008747	129864	6.1
22	2015	Dec	59.8	56.2	2138363	2007811	130552	6.1
22	2016	Jan	59.8	56.1	2137970	2006984	130986	6.1
22	2016	Feb	59.7	56.1	2136854	2005772	131082	6.1
22	2016	Mar	59.6	56	2134513	2003738	130775	6.1
22	2016	Apr	59.5	55.9	2131255	2000925	130330	6.1
22	2016	May	59.4	55.8	2127715	1997716	129999	6.1
22	2016	Jun	59.3	55.7	2124011	1994325	129686	6.1
22	2016	Jul	59.2	55.5	2120121	1990846	129275	6.1
22	2016	Aug	59	55.4	2116013	1987234	128779	6.1
22	2016	Sep	58.9	55.3	2111963	1983765	128198	6.1
22	2016	Oct	58.8	55.3	2108204	1980936	127268	6
22	2016	Nov	58.7	55.2	2105093	1979313	125780	6
22	2016	Dec	58.7	55.2	2103040	1979129	123911	5.9
22	2017	Jan	58.6	55.2	2102045	1980236	121809	5.8
22	2017	Feb	58.6	55.3	2101611	1982282	119329	5.7
22	2017	Mar	58.6	55.4	2101300	1984718	116582	5.5
22	2017	Apr	58.6	55.5	2101151	1987448	113703	5.4
22	2017	May	58.6	55.6	2101066	1990432	110634	5.3
22	2017	Jun	58.7	55.6	2101283	1993636	107647	5.1
22	2017	Jul	58.7	55.7	2102143	1997121	105022	5
22	2017	Aug	58.7	55.8	2103425	2000746	102679	4.9
22	2017	Sep	58.7	55.9	2104598	2004011	100587	4.8
22	2017	Oct	58.8	56	2105373	2006482	98891	4.7
22	2017	Nov	58.8	56	2105777	2007922	97855	4.6
22	2017	Dec	58.8	56.1	2105982	2008419	97563	4.6
22	2018	Jan	58.8	56.1	2106452	2008150	98302	4.7
22	2018	Feb	58.8	56	2107557	2007428	100129	4.8
22	2018	Mar	58.9	56	2108976	2006500	102476	4.9
22	2018	Apr	58.9	56	2109591	2005076	104515	5
22	2018	May	58.9	55.9	2108905	2003101	105804	5
22	2018	Jun	58.9	55.9	2107173	2001127	106046	5
22	2018	Jul	58.8	55.8	2104700	1999524	105176	5
22	2018	Aug	58.7	55.8	2102370	1998536	103834	4.9
22	2018	Sep	58.7	55.8	2100951	1998331	102620	4.9
22	2018	Oct	58.7	55.8	2100385	1998691	101694	4.8
22	2018	Nov	58.7	55.8	2100030	1999216	100814	4.8
22	2018	Dec	58.6	55.9	2099173	1999486	99687	4.7
22	2019	Jan	58.6	55.9	2097303	1999204	98099	4.7
22	2019	Feb	58.5	55.8	2094204	1998071	96133	4.6
22	2019	Mar	58.4	55.8	2090667	1996265	94402	4.5
22	2019	Apr	58.4	55.8	2087912	1994496	93416	4.5
22	2019	May	58.3	55.7	2086757	1993195	93562	4.5
22	2019	Jun	58.4	55.7	2087601	1992477	95124	4.6
22	2019	Jul	58.5	55.7	2090833	1992463	98370	4.7
22	2019	Aug	58.6	55.7	2094998	1992636	102362	4.9
22	2019	Sep	58.7	55.7	2099185	1993090	106095	5.1
22	2019	Oct	58.8	55.7	2102225	1993322	108903	5.2
22	2019	Nov	58.8	55.7	2102578	1993247	109331	5.2
22	2019	Dec	58.8	55.7	2102205	1993208	108997	5.2
22	2020	Jan	58.9	55.8	2107207	1995892	111315	5.3
22	2020	Feb	59	56	2109846	1999977	109869	5.2
23	2010	Jan	65.1	59.8	694243	637259	56984	8.2
23	2010	Feb	65.1	59.8	694475	637568	56907	8.2
23	2010	Mar	65.1	59.8	694551	637804	56747	8.2
23	2010	Apr	64.6	59.4	694445	637892	56553	8.1
23	2010	May	64.6	59.4	694263	637898	56365	8.1
23	2010	Jun	64.6	59.4	694172	637919	56253	8.1
23	2010	Jul	64.6	59.4	694326	638068	56258	8.1
23	2010	Aug	64.6	59.4	694797	638446	56351	8.1
23	2010	Sep	64.7	59.4	695496	639030	56466	8.1
23	2010	Oct	64.7	59.4	696286	639773	56513	8.1
23	2010	Nov	64.7	59.5	697017	640546	56471	8.1
23	2010	Dec	64.8	59.5	697569	641170	56399	8.1
23	2011	Jan	64.8	59.6	697917	641581	56336	8.1
23	2011	Feb	64.8	59.6	698122	641876	56246	8.1
23	2011	Mar	64.8	59.6	698290	642192	56098	8
23	2011	Apr	64.8	59.6	698498	642590	55908	8
23	2011	May	64.8	59.6	698778	643077	55701	8
23	2011	Jun	64.8	59.6	699095	643643	55452	7.9
23	2011	Jul	64.8	59.7	699417	644275	55142	7.9
23	2011	Aug	64.8	59.7	699732	644926	54806	7.8
23	2011	Sep	64.8	59.8	700037	645554	54483	7.8
23	2011	Oct	64.8	59.8	700335	646109	54226	7.7
23	2011	Nov	64.8	59.8	700617	646574	54043	7.7
23	2011	Dec	64.8	59.9	700893	646996	53897	7.7
23	2012	Jan	64.9	59.9	701198	647429	53769	7.7
23	2012	Feb	64.9	59.9	701539	647863	53676	7.7
23	2012	Mar	64.9	60	701851	648248	53603	7.6
23	2012	Apr	64.9	60	702059	648582	53477	7.6
23	2012	May	64.9	60	702207	648947	53260	7.6
23	2012	Jun	64.9	60	702345	649410	52935	7.5
23	2012	Jul	64.9	60.1	702503	649989	52514	7.5
23	2012	Aug	64.9	60.1	702735	650687	52048	7.4
23	2012	Sep	64.9	60.2	703085	651471	51614	7.3
23	2012	Oct	65	60.2	703508	652278	51230	7.3
23	2012	Nov	65	60.3	703960	653061	50899	7.2
23	2012	Dec	65	60.3	704418	653833	50585	7.2
23	2013	Jan	65	60.4	704819	654594	50225	7.1
23	2013	Feb	65.1	60.5	705153	655387	49766	7.1
23	2013	Mar	65.1	60.6	705438	656261	49177	7
23	2013	Apr	65.1	60.6	705741	657244	48497	6.9
23	2013	May	65.1	60.7	706045	658276	47769	6.8
23	2013	Jun	65.1	60.8	706309	659246	47063	6.7
23	2013	Jul	65.1	60.9	706447	660040	46407	6.6
23	2013	Aug	65.1	60.9	706313	660549	45764	6.5
23	2013	Sep	65	60.9	705866	660735	45131	6.4
23	2013	Oct	64.9	60.8	705193	660665	44528	6.3
23	2013	Nov	64.8	60.8	704399	660416	43983	6.2
23	2013	Dec	64.7	60.7	703514	660016	43498	6.2
23	2014	Jan	64.6	60.7	702680	659873	42807	6.1
23	2014	Feb	64.5	60.6	701531	659353	42178	6
23	2014	Mar	64.4	60.6	700411	658894	41517	5.9
23	2014	Apr	64.3	60.5	699286	658458	40828	5.8
23	2014	May	64.2	60.5	698114	657984	40130	5.7
23	2014	Jun	64	60.4	696914	657472	39442	5.7
23	2014	Jul	63.9	60.3	695717	656942	38775	5.6
23	2014	Aug	63.8	60.3	694591	656458	38133	5.5
23	2014	Sep	63.7	60.2	693527	656034	37493	5.4
23	2014	Oct	63.5	60.2	692411	655612	36799	5.3
23	2014	Nov	63.4	60.1	691163	655154	36009	5.2
23	2014	Dec	63.3	60.1	689844	654716	35128	5.1
23	2015	Jan	63.2	60	688572	654375	34197	5
23	2015	Feb	63.1	60	687279	653991	33288	4.8
23	2015	Mar	62.9	60	686056	653650	32406	4.7
23	2015	Apr	62.8	59.9	684922	653372	31550	4.6
23	2015	May	62.7	59.9	683865	653144	30721	4.5
23	2015	Jun	62.6	59.9	682852	652926	29926	4.4
23	2015	Jul	62.5	59.9	681899	652713	29186	4.3
23	2015	Aug	62.4	59.8	681068	652539	28529	4.2
23	2015	Sep	62.4	59.8	680513	652541	27972	4.1
23	2015	Oct	62.3	59.8	680417	652877	27540	4
23	2015	Nov	62.4	59.9	680886	653636	27250	4
23	2015	Dec	62.4	60	681856	654796	27060	4
23	2016	Jan	62.6	60.1	683163	656256	26907	3.9
23	2016	Feb	62.7	60.2	684668	657907	26761	3.9
23	2016	Mar	62.8	60.4	686265	659657	26608	3.9
23	2016	Apr	62.9	60.5	687866	661409	26457	3.8
23	2016	May	63.1	60.7	689420	663097	26323	3.8
23	2016	Jun	63.2	60.8	690907	664696	26211	3.8
23	2016	Jul	63.3	60.9	692302	666190	26112	3.8
23	2016	Aug	63.4	61	693590	667584	26006	3.7
23	2016	Sep	63.5	61.1	694732	668859	25873	3.7
23	2016	Oct	63.5	61.2	695680	670000	25680	3.7
23	2016	Nov	63.5	61.2	696425	671021	25404	3.6
23	2016	Dec	63.6	61.3	696972	671890	25082	3.6
23	2017	Jan	63.6	61.3	697362	672583	24779	3.6
23	2017	Feb	63.6	61.4	697622	673093	24529	3.5
23	2017	Mar	63.6	61.4	697763	673414	24349	3.5
23	2017	Apr	63.6	61.4	697864	673642	24222	3.5
23	2017	May	63.6	61.4	697957	673861	24096	3.5
23	2017	Jun	63.5	61.4	697997	674071	23926	3.4
23	2017	Jul	63.5	61.4	697961	674279	23682	3.4
23	2017	Aug	63.5	61.3	697809	674464	23345	3.3
23	2017	Sep	63.4	61.3	697541	674605	22936	3.3
23	2017	Oct	63.3	61.3	697219	674703	22516	3.2
23	2017	Nov	63.3	61.3	696903	674744	22159	3.2
23	2017	Dec	63.3	61.3	696687	674776	21911	3.1
23	2018	Jan	63.2	61.3	696632	674833	21799	3.1
23	2018	Feb	63.2	61.2	696733	674892	21841	3.1
23	2018	Mar	63.2	61.2	696866	674850	22016	3.2
23	2018	Apr	63.2	61.2	696824	674557	22267	3.2
23	2018	May	63.1	61.1	696527	673995	22532	3.2
23	2018	Jun	63.1	61	696051	673302	22749	3.3
23	2018	Jul	63	60.9	695495	672617	22878	3.3
23	2018	Aug	62.9	60.8	695006	672071	22935	3.3
23	2018	Sep	62.8	60.8	694698	671758	22940	3.3
23	2018	Oct	62.8	60.7	694573	671666	22907	3.3
23	2018	Nov	62.8	60.7	694538	671695	22843	3.3
23	2018	Dec	62.7	60.7	694432	671694	22738	3.3
23	2019	Jan	62.7	60.6	694085	671537	22548	3.2
23	2019	Feb	62.6	60.6	693390	671170	22220	3.2
23	2019	Mar	62.5	60.5	692476	670722	21754	3.1
23	2019	Apr	62.4	60.5	691620	670413	21207	3.1
23	2019	May	62.3	60.4	691074	670402	20672	3
23	2019	Jun	62.3	60.4	690978	670722	20256	2.9
23	2019	Jul	62.3	60.5	691444	671381	20063	2.9
23	2019	Aug	62.3	60.5	692182	672083	20099	2.9
23	2019	Sep	62.3	60.5	693045	672746	20299	2.9
23	2019	Oct	62.4	60.5	693661	673135	20526	3
23	2019	Nov	62.3	60.5	693715	673084	20631	3
23	2019	Dec	62.3	60.5	693630	672992	20638	3
23	2020	Jan	62.3	60.4	694174	672966	21208	3.1
23	2020	Feb	62.4	60.4	695024	672986	22038	3.2
24	2010	Jan	68.9	63.5	3045709	2809483	236226	7.8
24	2010	Feb	69	63.6	3052675	2814636	238039	7.8
24	2010	Mar	69.1	63.7	3059579	2821365	238214	7.8
24	2010	Apr	68.3	63	3066143	2828799	237344	7.7
24	2010	May	68.3	63.1	3071885	2836057	235828	7.7
24	2010	Jun	68.4	63.2	3076363	2842041	234322	7.6
24	2010	Jul	68.4	63.2	3079776	2846212	233564	7.6
24	2010	Aug	68.4	63.2	3082617	2848902	233715	7.6
24	2010	Sep	68.4	63.2	3085181	2850945	234236	7.6
24	2010	Oct	68.3	63.1	3087456	2853374	234082	7.6
24	2010	Nov	68.3	63.2	3089014	2856294	232720	7.5
24	2010	Dec	68.3	63.2	3089859	2859358	230501	7.5
24	2011	Jan	68.2	63.2	3090479	2862249	228230	7.4
24	2011	Feb	68.2	63.2	3091021	2864605	226416	7.3
24	2011	Mar	68.1	63.2	3091247	2866135	225112	7.3
24	2011	Apr	68.1	63.1	3091373	2866735	224638	7.3
24	2011	May	68	63.1	3092081	2866875	225206	7.3
24	2011	Jun	68	63	3093578	2867381	226197	7.3
24	2011	Jul	68	63	3095695	2869031	226664	7.3
24	2011	Aug	68	63	3098139	2871972	226167	7.3
24	2011	Sep	68	63	3100657	2875949	224708	7.2
24	2011	Oct	67.9	63.1	3103191	2880494	222697	7.2
24	2011	Nov	67.9	63.1	3105475	2884942	220533	7.1
24	2011	Dec	67.9	63.1	3107187	2888674	218513	7
24	2012	Jan	67.9	63.1	3108528	2891475	217053	7
24	2012	Feb	67.9	63.1	3109961	2893448	216513	7
24	2012	Mar	67.8	63.1	3111600	2894610	216990	7
24	2012	Apr	67.8	63.1	3113159	2895270	217889	7
24	2012	May	67.8	63	3114818	2896228	218590	7
24	2012	Jun	67.8	63	3116856	2898073	218783	7
24	2012	Jul	67.8	63	3119340	2900954	218386	7
24	2012	Aug	67.8	63.1	3122375	2904721	217654	7
24	2012	Sep	67.8	63.1	3125936	2908979	216957	6.9
24	2012	Oct	67.8	63.1	3129327	2912948	216379	6.9
24	2012	Nov	67.8	63.2	3132092	2916116	215976	6.9
24	2012	Dec	67.8	63.2	3133899	2918293	215606	6.9
24	2013	Jan	67.8	63.2	3134588	2919421	215167	6.9
24	2013	Feb	67.8	63.1	3134392	2919922	214470	6.8
24	2013	Mar	67.7	63.1	3133730	2920462	213268	6.8
24	2013	Apr	67.7	63.1	3132990	2921598	211392	6.7
24	2013	May	67.6	63.1	3132238	2922988	209250	6.7
24	2013	Jun	67.5	63.1	3131551	2924211	207340	6.6
24	2013	Jul	67.5	63	3130720	2925103	205617	6.6
24	2013	Aug	67.4	63	3129141	2925572	203569	6.5
24	2013	Sep	67.3	63	3126736	2925718	201018	6.4
24	2013	Oct	67.2	62.9	3124293	2925915	198378	6.3
24	2013	Nov	67.1	62.9	3122467	2926606	195861	6.3
24	2013	Dec	67.1	62.9	3121406	2927943	193463	6.2
24	2014	Jan	66.9	62.8	3115253	2924909	190344	6.1
24	2014	Feb	66.9	62.9	3115406	2927511	187895	6
24	2014	Mar	66.9	62.9	3116395	2930290	186105	6
24	2014	Apr	66.9	62.9	3117945	2932833	185112	5.9
24	2014	May	66.9	62.9	3119672	2935393	184279	5.9
24	2014	Jun	66.9	63	3121560	2938490	183070	5.9
24	2014	Jul	66.9	63	3123563	2942049	181514	5.8
24	2014	Aug	66.9	63.1	3125809	2945982	179827	5.8
24	2014	Sep	66.9	63.1	3128126	2950057	178069	5.7
24	2014	Oct	66.9	63.1	3129996	2953855	176141	5.6
24	2014	Nov	66.9	63.2	3131085	2957030	174055	5.6
24	2014	Dec	66.9	63.2	3131935	2959765	172170	5.5
24	2015	Jan	66.9	63.2	3132769	2962280	170489	5.4
24	2015	Feb	66.9	63.3	3134866	2965800	169066	5.4
24	2015	Mar	66.9	63.3	3137340	2969972	167368	5.3
24	2015	Apr	66.9	63.4	3139824	2974548	165276	5.3
24	2015	May	67	63.5	3141809	2978836	162973	5.2
24	2015	Jun	66.9	63.5	3142875	2982227	160648	5.1
24	2015	Jul	66.9	63.5	3143255	2984790	158465	5
24	2015	Aug	66.9	63.6	3143328	2986966	156362	5
24	2015	Sep	66.9	63.6	3143475	2989353	154122	4.9
24	2015	Oct	66.9	63.6	3144384	2992627	151757	4.8
24	2015	Nov	66.9	63.7	3146374	2996933	149441	4.7
24	2015	Dec	66.9	63.8	3148903	3001702	147201	4.7
24	2016	Jan	67	63.9	3151182	3006161	145021	4.6
24	2016	Feb	67	64	3152907	3009793	143114	4.5
24	2016	Mar	67	64	3154121	3012566	141555	4.5
24	2016	Apr	67	64	3155461	3014940	140521	4.5
24	2016	May	67.1	64.1	3157689	3017580	140109	4.4
24	2016	Jun	67.1	64.1	3161020	3020855	140165	4.4
24	2016	Jul	67.2	64.2	3165311	3024916	140395	4.4
24	2016	Aug	67.3	64.3	3170346	3029620	140726	4.4
24	2016	Sep	67.3	64.3	3175756	3034632	141124	4.4
24	2016	Oct	67.4	64.4	3180773	3039575	141198	4.4
24	2016	Nov	67.5	64.5	3185102	3044368	140734	4.4
24	2016	Dec	67.5	64.6	3188861	3049016	139845	4.4
24	2017	Jan	67.6	64.6	3192342	3053498	138844	4.3
24	2017	Feb	67.6	64.7	3195617	3057764	137853	4.3
24	2017	Mar	67.7	64.8	3198457	3061471	136986	4.3
24	2017	Apr	67.7	64.8	3200983	3064767	136216	4.3
24	2017	May	67.7	64.9	3203310	3067910	135400	4.2
24	2017	Jun	67.7	64.9	3205514	3070819	134695	4.2
24	2017	Jul	67.8	64.9	3207616	3073260	134356	4.2
24	2017	Aug	67.8	64.9	3209188	3074875	134313	4.2
24	2017	Sep	67.8	64.9	3210100	3075642	134458	4.2
24	2017	Oct	67.7	64.9	3210572	3075870	134702	4.2
24	2017	Nov	67.7	64.9	3210715	3075849	134866	4.2
24	2017	Dec	67.7	64.9	3210795	3076150	134645	4.2
24	2018	Jan	67.7	64.9	3211332	3077302	134030	4.2
24	2018	Feb	67.7	64.9	3212769	3079632	133137	4.1
24	2018	Mar	67.8	65	3215039	3082972	132067	4.1
24	2018	Apr	67.8	65	3217255	3086407	130848	4.1
24	2018	May	67.8	65.1	3218813	3089248	129565	4
24	2018	Jun	67.8	65.1	3219749	3091687	128062	4
24	2018	Jul	67.8	65.2	3220397	3094189	126208	3.9
24	2018	Aug	67.8	65.2	3221740	3097316	124424	3.9
24	2018	Sep	67.9	65.3	3224397	3101348	123049	3.8
24	2018	Oct	67.9	65.3	3228414	3106182	122232	3.8
24	2018	Nov	68	65.4	3233406	3111513	121893	3.8
24	2018	Dec	68.1	65.5	3238549	3116742	121807	3.8
24	2019	Jan	68.2	65.6	3242979	3121324	121655	3.8
24	2019	Feb	68.2	65.7	3246181	3124998	121183	3.7
24	2019	Mar	68.3	65.8	3248606	3128100	120506	3.7
24	2019	Apr	68.3	65.8	3251116	3131352	119764	3.7
24	2019	May	68.4	65.9	3254239	3135190	119049	3.7
24	2019	Jun	68.5	66	3258184	3139739	118445	3.6
24	2019	Jul	68.5	66.1	3263140	3145585	117555	3.6
24	2019	Aug	68.6	66.2	3267477	3151418	116059	3.6
24	2019	Sep	68.7	66.3	3271010	3156844	114166	3.5
24	2019	Oct	68.7	66.3	3273101	3160658	112443	3.4
24	2019	Nov	68.7	66.3	3272834	3160936	111898	3.4
24	2019	Dec	68.6	66.3	3272378	3160365	112013	3.4
24	2020	Jan	68.7	66.4	3276524	3167463	109061	3.3
24	2020	Feb	68.8	66.5	3280471	3172964	107507	3.3
25	2010	Jan	66.1	60.3	3476509	3171979	304530	8.8
25	2010	Feb	66.1	60.3	3482040	3178085	303955	8.7
25	2010	Mar	66.2	60.4	3485942	3183829	302113	8.7
25	2010	Apr	66.8	61	3487331	3188377	298954	8.6
25	2010	May	66.6	61	3486138	3191639	294499	8.4
25	2010	Jun	66.5	61	3482961	3193402	289559	8.3
25	2010	Jul	66.4	60.9	3479296	3194060	285236	8.2
25	2010	Aug	66.2	60.9	3476501	3194536	281965	8.1
25	2010	Sep	66.1	60.8	3474837	3195212	279625	8
25	2010	Oct	66.1	60.8	3474546	3196849	277697	8
25	2010	Nov	66	60.8	3474959	3199393	275566	7.9
25	2010	Dec	66	60.8	3474994	3202241	272753	7.8
25	2011	Jan	65.9	60.8	3474410	3205064	269346	7.8
25	2011	Feb	65.8	60.8	3472847	3207200	265647	7.6
25	2011	Mar	65.7	60.8	3470079	3208279	261800	7.5
25	2011	Apr	65.6	60.7	3466650	3208436	258214	7.4
25	2011	May	65.5	60.7	3463870	3208618	255252	7.4
25	2011	Jun	65.4	60.7	3462711	3210071	252640	7.3
25	2011	Jul	65.4	60.7	3463633	3213681	249952	7.2
25	2011	Aug	65.4	60.7	3466253	3219111	247142	7.1
25	2011	Sep	65.4	60.8	3469527	3225301	244226	7
25	2011	Oct	65.4	60.8	3472273	3230979	241294	6.9
25	2011	Nov	65.3	60.9	3473592	3235153	238439	6.9
25	2011	Dec	65.3	60.8	3473394	3237614	235780	6.8
25	2012	Jan	65.2	60.8	3472361	3238875	233486	6.7
25	2012	Feb	65.1	60.8	3471702	3240019	231683	6.7
25	2012	Mar	65.1	60.8	3472122	3241435	230687	6.6
25	2012	Apr	65.1	60.8	3473518	3243151	230367	6.6
25	2012	May	65.1	60.8	3476254	3245796	230458	6.6
25	2012	Jun	65.1	60.8	3480397	3249583	230814	6.6
25	2012	Jul	65.1	60.8	3485409	3254117	231292	6.6
25	2012	Aug	65.2	60.8	3490901	3258848	232053	6.6
25	2012	Sep	65.2	60.8	3496582	3263317	233265	6.7
25	2012	Oct	65.2	60.9	3501337	3266628	234709	6.7
25	2012	Nov	65.2	60.8	3504465	3268252	236213	6.7
25	2012	Dec	65.2	60.8	3505939	3268333	237606	6.8
25	2013	Jan	65.2	60.7	3506305	3267341	238964	6.8
25	2013	Feb	65.1	60.7	3506639	3266350	240289	6.9
25	2013	Mar	65.1	60.6	3507938	3266573	241365	6.9
25	2013	Apr	65.1	60.6	3510733	3268819	241914	6.9
25	2013	May	65.1	60.6	3514060	3272148	241912	6.9
25	2013	Jun	65.1	60.6	3516697	3275355	241342	6.9
25	2013	Jul	65	60.6	3517932	3277961	239971	6.8
25	2013	Aug	65	60.6	3517355	3280063	237292	6.7
25	2013	Sep	64.9	60.6	3515673	3282306	233367	6.6
25	2013	Oct	64.8	60.6	3514864	3285781	229083	6.5
25	2013	Nov	64.8	60.6	3516363	3291319	225044	6.4
25	2013	Dec	64.8	60.7	3520340	3298878	221462	6.3
25	2014	Jan	64.8	60.8	3524591	3305785	218806	6.2
25	2014	Feb	64.9	61	3532726	3317396	215330	6.1
25	2014	Mar	65	61.1	3541136	3328806	212330	6
25	2014	Apr	65.1	61.3	3548933	3338848	210085	5.9
25	2014	May	65.2	61.4	3556183	3347896	208287	5.9
25	2014	Jun	65.3	61.5	3563949	3357342	206607	5.8
25	2014	Jul	65.4	61.6	3572506	3367638	204868	5.7
25	2014	Aug	65.5	61.8	3581751	3378815	202936	5.7
25	2014	Sep	65.6	62	3590865	3390352	200513	5.6
25	2014	Oct	65.7	62.1	3598465	3401226	197239	5.5
25	2014	Nov	65.8	62.2	3603367	3410255	193112	5.4
25	2014	Dec	65.8	62.3	3605703	3416840	188863	5.2
25	2015	Jan	65.7	62.4	3605565	3420586	184979	5.1
25	2015	Feb	65.7	62.4	3604189	3421937	182252	5.1
25	2015	Mar	65.6	62.3	3601628	3421572	180056	5
25	2015	Apr	65.5	62.3	3598244	3420283	177961	4.9
25	2015	May	65.4	62.2	3594041	3418247	175794	4.9
25	2015	Jun	65.3	62.1	3589008	3415511	173497	4.8
25	2015	Jul	65.1	62	3583980	3412819	171161	4.8
25	2015	Aug	65	61.9	3580000	3411127	168873	4.7
25	2015	Sep	64.9	61.9	3577728	3411294	166434	4.7
25	2015	Oct	64.9	61.9	3577835	3414029	163806	4.6
25	2015	Nov	64.9	62	3580579	3419462	161117	4.5
25	2015	Dec	64.9	62.1	3585033	3426836	158197	4.4
25	2016	Jan	65	62.2	3589829	3435046	154783	4.3
25	2016	Feb	65	62.3	3594275	3443299	150976	4.2
25	2016	Mar	65.1	62.4	3598313	3451350	146963	4.1
25	2016	Apr	65.1	62.5	3602471	3459357	143114	4
25	2016	May	65.2	62.7	3607409	3467632	139777	3.9
25	2016	Jun	65.2	62.8	3613102	3475999	137103	3.8
25	2016	Jul	65.3	62.9	3619261	3484124	135137	3.7
25	2016	Aug	65.4	63	3625622	3491559	134063	3.7
25	2016	Sep	65.4	63	3632086	3497961	134125	3.7
25	2016	Oct	65.5	63.1	3638490	3503404	135086	3.7
25	2016	Nov	65.6	63.1	3644912	3508570	136342	3.7
25	2016	Dec	65.7	63.2	3651575	3514023	137552	3.8
25	2017	Jan	65.7	63.3	3658490	3519862	138628	3.8
25	2017	Feb	65.8	63.3	3665221	3525821	139400	3.8
25	2017	Mar	65.9	63.4	3671099	3531228	139871	3.8
25	2017	Apr	66	63.4	3676244	3536178	140066	3.8
25	2017	May	66	63.5	3680990	3541090	139900	3.8
25	2017	Jun	66	63.5	3685642	3546165	139477	3.8
25	2017	Jul	66.1	63.6	3690606	3551639	138967	3.8
25	2017	Aug	66.1	63.7	3695906	3557650	138256	3.7
25	2017	Sep	66.2	63.8	3701711	3564432	137279	3.7
25	2017	Oct	66.3	63.9	3708326	3572182	136144	3.7
25	2017	Nov	66.4	64	3716022	3580888	135134	3.6
25	2017	Dec	66.5	64.1	3725250	3591029	134221	3.6
25	2018	Jan	66.7	64.3	3736286	3602886	133400	3.6
25	2018	Feb	66.9	64.6	3748938	3616193	132745	3.5
25	2018	Mar	67.1	64.8	3762067	3629933	132134	3.5
25	2018	Apr	67.3	65	3773854	3642519	131335	3.5
25	2018	May	67.5	65.1	3783261	3652972	130289	3.4
25	2018	Jun	67.5	65.3	3790370	3661467	128903	3.4
25	2018	Jul	67.6	65.3	3795629	3668492	127137	3.3
25	2018	Aug	67.7	65.4	3800026	3674675	125351	3.3
25	2018	Sep	67.7	65.5	3804087	3680361	123726	3.3
25	2018	Oct	67.7	65.6	3807636	3685380	122256	3.2
25	2018	Nov	67.8	65.6	3810080	3689148	120932	3.2
25	2018	Dec	67.8	65.6	3810634	3690899	119735	3.1
25	2019	Jan	67.7	65.6	3809095	3690557	118538	3.1
25	2019	Feb	67.6	65.6	3805911	3688825	117086	3.1
25	2019	Mar	67.6	65.5	3802648	3687207	115441	3
25	2019	Apr	67.5	65.5	3801080	3687342	113738	3
25	2019	May	67.5	65.5	3802246	3690098	112148	2.9
25	2019	Jun	67.6	65.6	3806480	3695671	110809	2.9
25	2019	Jul	67.7	65.7	3813991	3704388	109603	2.9
25	2019	Aug	67.8	65.9	3822170	3713768	108402	2.8
25	2019	Sep	67.9	66	3829750	3722387	107363	2.8
25	2019	Oct	68	66.1	3834887	3728268	106619	2.8
25	2019	Nov	67.9	66.1	3835120	3728610	106510	2.8
25	2019	Dec	67.9	66	3834262	3727633	106629	2.8
25	2020	Jan	67.9	66	3836148	3729899	106249	2.8
25	2020	Feb	67.9	66	3834913	3728387	106526	2.8
26	2010	Jan	62.4	53.8	4855813	4182856	672957	13.9
26	2010	Feb	62.4	53.9	4855867	4190694	665173	13.7
26	2010	Mar	62.4	54	4852237	4198486	653751	13.5
26	2010	Apr	62.8	54.5	4843967	4204439	639528	13.2
26	2010	May	62.6	54.5	4831063	4207937	623126	12.9
26	2010	Jun	62.4	54.5	4814161	4207785	606376	12.6
26	2010	Jul	62.1	54.4	4795586	4203795	591791	12.3
26	2010	Aug	61.8	54.3	4777886	4197604	580282	12.1
26	2010	Sep	61.6	54.2	4761178	4190675	570503	12
26	2010	Oct	61.4	54.1	4745388	4185504	559884	11.8
26	2010	Nov	61.1	54.1	4729812	4183097	546715	11.6
26	2010	Dec	60.9	54.1	4714537	4182818	531719	11.3
26	2011	Jan	60.7	54.1	4701777	4183976	517801	11
26	2011	Feb	60.6	54.1	4691995	4184968	507027	10.8
26	2011	Mar	60.5	54	4684462	4184534	499928	10.7
26	2011	Apr	60.4	54	4679264	4182433	496831	10.6
26	2011	May	60.4	53.9	4677237	4180118	497119	10.6
26	2011	Jun	60.4	53.9	4678195	4180411	497784	10.6
26	2011	Jul	60.4	54	4681303	4185550	495753	10.6
26	2011	Aug	60.4	54.1	4685085	4195308	489777	10.5
26	2011	Sep	60.4	54.2	4687766	4207816	479950	10.2
26	2011	Oct	60.4	54.3	4688248	4220674	467574	10
26	2011	Nov	60.3	54.5	4685490	4231243	454247	9.7
26	2011	Dec	60.2	54.5	4679866	4238039	441827	9.4
26	2012	Jan	60.1	54.5	4673008	4240922	432086	9.2
26	2012	Feb	60	54.5	4667565	4241203	426362	9.1
26	2012	Mar	60	54.5	4664770	4239532	425238	9.1
26	2012	Apr	59.9	54.4	4663599	4236729	426870	9.2
26	2012	May	59.9	54.4	4663931	4235014	428917	9.2
26	2012	Jun	59.9	54.4	4665410	4235749	429661	9.2
26	2012	Jul	59.9	54.4	4667492	4239436	428056	9.2
26	2012	Aug	59.9	54.5	4670977	4245751	425226	9.1
26	2012	Sep	60	54.5	4677098	4253618	423480	9.1
26	2012	Oct	60	54.6	4684580	4261214	423366	9
26	2012	Nov	60.1	54.7	4691792	4267199	424593	9
26	2012	Dec	60.2	54.7	4697631	4271672	425959	9.1
26	2013	Jan	60.2	54.7	4703361	4275441	427920	9.1
26	2013	Feb	60.2	54.8	4706912	4279951	426961	9.1
26	2013	Mar	60.3	54.9	4711042	4286557	424485	9
26	2013	Apr	60.3	55	4717423	4295938	421485	8.9
26	2013	May	60.4	55.1	4724984	4305660	419324	8.9
26	2013	Jun	60.5	55.1	4732138	4313404	418734	8.8
26	2013	Jul	60.5	55.2	4737307	4318219	419088	8.8
26	2013	Aug	60.5	55.2	4737880	4320513	417367	8.8
26	2013	Sep	60.4	55.2	4734194	4322206	411988	8.7
26	2013	Oct	60.4	55.2	4730318	4325650	404668	8.6
26	2013	Nov	60.3	55.3	4729736	4332412	397324	8.4
26	2013	Dec	60.4	55.4	4732893	4341899	390994	8.3
26	2014	Jan	60.5	55.6	4744732	4360567	384165	8.1
26	2014	Feb	60.5	55.7	4751001	4372418	378583	8
26	2014	Mar	60.6	55.9	4756613	4383816	372797	7.8
26	2014	Apr	60.6	56	4760159	4393452	366707	7.7
26	2014	May	60.6	56.1	4761733	4402117	359616	7.6
26	2014	Jun	60.6	56.2	4762982	4411550	351432	7.4
26	2014	Jul	60.6	56.3	4764355	4421797	342558	7.2
26	2014	Aug	60.6	56.4	4766783	4432811	333972	7
26	2014	Sep	60.6	56.5	4769352	4443750	325602	6.8
26	2014	Oct	60.6	56.6	4769249	4453135	316114	6.6
26	2014	Nov	60.5	56.7	4764938	4459823	305115	6.4
26	2014	Dec	60.5	56.7	4758582	4464293	294289	6.2
26	2015	Jan	60.4	56.7	4751644	4466114	285530	6
26	2015	Feb	60.3	56.8	4748095	4468558	279537	5.9
26	2015	Mar	60.3	56.8	4747543	4472101	275442	5.8
26	2015	Apr	60.3	56.9	4749308	4477673	271635	5.7
26	2015	May	60.3	56.9	4751569	4484720	266849	5.6
26	2015	Jun	60.3	57	4752890	4492149	260741	5.5
26	2015	Jul	60.3	57.1	4753877	4499799	254078	5.3
26	2015	Aug	60.3	57.2	4755590	4507911	247679	5.2
26	2015	Sep	60.3	57.3	4759182	4517377	241805	5.1
26	2015	Oct	60.4	57.4	4766848	4529361	237487	5
26	2015	Nov	60.5	57.6	4779293	4543703	235590	4.9
26	2015	Dec	60.7	57.7	4794185	4558713	235472	4.9
26	2016	Jan	60.9	57.9	4808390	4572298	236092	4.9
26	2016	Feb	61	58	4820082	4583086	236996	4.9
26	2016	Mar	61.1	58.1	4828596	4590759	237837	4.9
26	2016	Apr	61.2	58.1	4835043	4596255	238788	4.9
26	2016	May	61.2	58.2	4841159	4601005	240154	5
26	2016	Jun	61.3	58.2	4847382	4605690	241692	5
26	2016	Jul	61.3	58.2	4853563	4610543	243020	5
26	2016	Aug	61.4	58.3	4859508	4615193	244315	5
26	2016	Sep	61.4	58.3	4865286	4619004	246282	5.1
26	2016	Oct	61.4	58.3	4869773	4621804	247969	5.1
26	2016	Nov	61.4	58.3	4872226	4624704	247522	5.1
26	2016	Dec	61.4	58.3	4872911	4628778	244133	5
26	2017	Jan	61.4	58.4	4872537	4634443	238094	4.9
26	2017	Feb	61.4	58.5	4871666	4641291	230375	4.7
26	2017	Mar	61.3	58.5	4870707	4647704	223003	4.6
26	2017	Apr	61.3	58.6	4871408	4653371	218037	4.5
26	2017	May	61.4	58.6	4874830	4658487	216343	4.4
26	2017	Jun	61.4	58.7	4880622	4662760	217862	4.5
26	2017	Jul	61.5	58.7	4887810	4665932	221878	4.5
26	2017	Aug	61.5	58.7	4893887	4667621	226266	4.6
26	2017	Sep	61.5	58.7	4896914	4668084	228830	4.7
26	2017	Oct	61.5	58.6	4896847	4668169	228678	4.7
26	2017	Nov	61.5	58.6	4894842	4668314	226528	4.6
26	2017	Dec	61.4	58.6	4892769	4669708	223061	4.6
26	2018	Jan	61.4	58.7	4893013	4673543	219470	4.5
26	2018	Feb	61.5	58.7	4896797	4680362	216435	4.4
26	2018	Mar	61.5	58.8	4902556	4689149	213407	4.4
26	2018	Apr	61.6	58.9	4906354	4696814	209540	4.3
26	2018	May	61.6	59	4906591	4701549	205042	4.2
26	2018	Jun	61.5	59	4904788	4704304	200484	4.1
26	2018	Jul	61.5	59	4902784	4706636	196148	4
26	2018	Aug	61.5	59	4903662	4710140	193522	3.9
26	2018	Sep	61.5	59.1	4908817	4715487	193330	3.9
26	2018	Oct	61.6	59.1	4917430	4722041	195389	4
26	2018	Nov	61.7	59.2	4927529	4728438	199091	4
26	2018	Dec	61.8	59.3	4936053	4732540	203513	4.1
26	2019	Jan	61.9	59.3	4940173	4732779	207394	4.2
26	2019	Feb	61.8	59.2	4938994	4729147	209847	4.2
26	2019	Mar	61.8	59.1	4935119	4724022	211097	4.3
26	2019	Apr	61.7	59.1	4931798	4720814	210984	4.3
26	2019	May	61.7	59.1	4930397	4721029	209368	4.2
26	2019	Jun	61.7	59.1	4931142	4724570	206572	4.2
26	2019	Jul	61.7	59.2	4934220	4731577	202643	4.1
26	2019	Aug	61.8	59.3	4937225	4739403	197822	4
26	2019	Sep	61.8	59.3	4939952	4746565	193387	3.9
26	2019	Oct	61.8	59.4	4941513	4750986	190527	3.9
26	2019	Nov	61.8	59.4	4941316	4750962	190354	3.9
26	2019	Dec	61.7	59.4	4941082	4750088	190994	3.9
26	2020	Jan	61.8	59.5	4946724	4759515	187209	3.8
26	2020	Feb	61.8	59.6	4950003	4769640	180363	3.6
27	2010	Jan	71.5	66	2931636	2705380	226256	7.7
27	2010	Feb	71.5	66	2934157	2709231	224926	7.7
27	2010	Mar	71.5	66.1	2936270	2713397	222873	7.6
27	2010	Apr	71.5	66.1	2937670	2717445	220225	7.5
27	2010	May	71.5	66.2	2938435	2721066	217369	7.4
27	2010	Jun	71.4	66.2	2938805	2723778	215027	7.3
27	2010	Jul	71.4	66.2	2939250	2725306	213944	7.3
27	2010	Aug	71.4	66.2	2940138	2725971	214167	7.3
27	2010	Sep	71.3	66.1	2941269	2726480	214789	7.3
27	2010	Oct	71.3	66.1	2942146	2727688	214458	7.3
27	2010	Nov	71.3	66.1	2942245	2729932	212313	7.2
27	2010	Dec	71.2	66.1	2941809	2733191	208618	7.1
27	2011	Jan	71.1	66.2	2941435	2737393	204042	6.9
27	2011	Feb	71.1	66.3	2941838	2741696	200142	6.8
27	2011	Mar	71.1	66.3	2943124	2745212	197912	6.7
27	2011	Apr	71.1	66.3	2945087	2747838	197249	6.7
27	2011	May	71.1	66.3	2947426	2749971	197455	6.7
27	2011	Jun	71.1	66.4	2949387	2752143	197244	6.7
27	2011	Jul	71.1	66.4	2950563	2755094	195469	6.6
27	2011	Aug	71	66.4	2950646	2758898	191748	6.5
27	2011	Sep	70.9	66.5	2949489	2762924	186565	6.3
27	2011	Oct	70.8	66.5	2947613	2766525	181088	6.1
27	2011	Nov	70.8	66.5	2945429	2769210	176219	6
27	2011	Dec	70.7	66.5	2943191	2770778	172413	5.9
27	2012	Jan	70.6	66.5	2941312	2771438	169874	5.8
27	2012	Feb	70.5	66.5	2940126	2771941	168185	5.7
27	2012	Mar	70.4	66.4	2939631	2772639	166992	5.7
27	2012	Apr	70.4	66.4	2939742	2773408	166334	5.7
27	2012	May	70.4	66.4	2940579	2774614	165965	5.6
27	2012	Jun	70.4	66.4	2942474	2776729	165745	5.6
27	2012	Jul	70.4	66.4	2945136	2779732	165404	5.6
27	2012	Aug	70.4	66.5	2948475	2783485	164990	5.6
27	2012	Sep	70.4	66.5	2952420	2787876	164544	5.6
27	2012	Oct	70.5	66.6	2955833	2792315	163518	5.5
27	2012	Nov	70.5	66.6	2958006	2796171	161835	5.5
27	2012	Dec	70.4	66.6	2958803	2799077	159726	5.4
27	2013	Jan	70.4	66.6	2958448	2801058	157390	5.3
27	2013	Feb	70.3	66.6	2957536	2802512	155024	5.2
27	2013	Mar	70.3	66.6	2956696	2803957	152739	5.2
27	2013	Apr	70.2	66.7	2956563	2805906	150657	5.1
27	2013	May	70.2	66.7	2957110	2808169	148941	5
27	2013	Jun	70.2	66.7	2957938	2810445	147493	5
27	2013	Jul	70.1	66.7	2958811	2812690	146121	4.9
27	2013	Aug	70.1	66.7	2959293	2814962	144331	4.9
27	2013	Sep	70	66.7	2959346	2817257	142089	4.8
27	2013	Oct	70	66.7	2959868	2819676	140192	4.7
27	2013	Nov	70	66.7	2961337	2822308	139029	4.7
27	2013	Dec	70	66.7	2963292	2825014	138278	4.7
27	2014	Jan	70	66.7	2964752	2827317	137435	4.6
27	2014	Feb	70	66.8	2966238	2830253	135985	4.6
27	2014	Mar	70	66.8	2967430	2833677	133753	4.5
27	2014	Apr	69.9	66.9	2968228	2837486	130742	4.4
27	2014	May	69.9	66.9	2968773	2841721	127052	4.3
27	2014	Jun	69.9	67	2969723	2846504	123219	4.1
27	2014	Jul	69.9	67.1	2971460	2851481	119979	4
27	2014	Aug	69.9	67.1	2974054	2856280	117774	4
27	2014	Sep	69.9	67.2	2977012	2860581	116431	3.9
27	2014	Oct	69.9	67.2	2979545	2864148	115397	3.9
27	2014	Nov	69.9	67.2	2981152	2867002	114150	3.8
27	2014	Dec	69.9	67.3	2982491	2869598	112893	3.8
27	2015	Jan	70	67.3	2986322	2874200	112122	3.8
27	2015	Feb	70	67.4	2988962	2877096	111866	3.7
27	2015	Mar	70.1	67.4	2992271	2880260	112011	3.7
27	2015	Apr	70.1	67.5	2995715	2883633	112082	3.7
27	2015	May	70.1	67.5	2998720	2886844	111876	3.7
27	2015	Jun	70.1	67.5	3000794	2889448	111346	3.7
27	2015	Jul	70.1	67.5	3001995	2891466	110529	3.7
27	2015	Aug	70.1	67.5	3002926	2893249	109677	3.7
27	2015	Sep	70.1	67.5	3004387	2895400	108987	3.6
27	2015	Oct	70.1	67.5	3007353	2898465	108888	3.6
27	2015	Nov	70.1	67.6	3012066	2902407	109659	3.6
27	2015	Dec	70.2	67.6	3017428	2906659	110769	3.7
27	2016	Jan	70.3	67.7	3022094	2910450	111644	3.7
27	2016	Feb	70.3	67.7	3025460	2913180	112280	3.7
27	2016	Mar	70.3	67.7	3027550	2914689	112861	3.7
27	2016	Apr	70.3	67.7	3029031	2915312	113719	3.8
27	2016	May	70.3	67.6	3030768	2915661	115107	3.8
27	2016	Jun	70.3	67.6	3033097	2916186	116911	3.9
27	2016	Jul	70.3	67.6	3036017	2917152	118865	3.9
27	2016	Aug	70.3	67.5	3039275	2918624	120651	4
27	2016	Sep	70.3	67.5	3042451	2920504	121947	4
27	2016	Oct	70.3	67.5	3044793	2922732	122061	4
27	2016	Nov	70.3	67.5	3046156	2925607	120549	4
27	2016	Dec	70.3	67.6	3047127	2929230	117897	3.9
27	2017	Jan	70.3	67.6	3048278	2933511	114767	3.8
27	2017	Feb	70.3	67.7	3049745	2938220	111525	3.7
27	2017	Mar	70.3	67.8	3051441	2942677	108764	3.6
27	2017	Apr	70.3	67.8	3053567	2946664	106903	3.5
27	2017	May	70.3	67.8	3055914	2950324	105590	3.5
27	2017	Jun	70.3	67.9	3058239	2953742	104497	3.4
27	2017	Jul	70.3	67.9	3060454	2956931	103523	3.4
27	2017	Aug	70.2	67.9	3061889	2959715	102174	3.3
27	2017	Sep	70.2	67.9	3062333	2962056	100277	3.3
27	2017	Oct	70.1	67.9	3062047	2964049	97998	3.2
27	2017	Nov	70.1	67.9	3061481	2965577	95904	3.1
27	2017	Dec	70	67.9	3061162	2966934	94228	3.1
27	2018	Jan	70	67.9	3061622	2968564	93058	3
27	2018	Feb	70	67.9	3063130	2970767	92363	3
27	2018	Mar	70	67.9	3065197	2973525	91672	3
27	2018	Apr	70	67.9	3066759	2976186	90573	3
27	2018	May	70	67.9	3067566	2978174	89392	2.9
27	2018	Jun	69.9	67.9	3067978	2979644	88334	2.9
27	2018	Jul	69.9	67.9	3068467	2981142	87325	2.8
27	2018	Aug	69.9	67.9	3070293	2983142	87151	2.8
27	2018	Sep	69.9	67.9	3073942	2985670	88272	2.9
27	2018	Oct	70	67.9	3079042	2988502	90540	2.9
27	2018	Nov	70	67.9	3084727	2991361	93366	3
27	2018	Dec	70.1	67.9	3089750	2993761	95989	3.1
27	2019	Jan	70.2	67.9	3093308	2995382	97926	3.2
27	2019	Feb	70.2	67.9	3095337	2996333	99004	3.2
27	2019	Mar	70.2	67.9	3096730	2997265	99465	3.2
27	2019	Apr	70.2	67.9	3098456	2999023	99433	3.2
27	2019	May	70.2	67.9	3101106	3002006	99100	3.2
27	2019	Jun	70.2	68	3105019	3006047	98972	3.2
27	2019	Jul	70.3	68	3110509	3011020	99489	3.2
27	2019	Aug	70.4	68.1	3115785	3015505	100280	3.2
27	2019	Sep	70.4	68.1	3120459	3019383	101076	3.2
27	2019	Oct	70.4	68.1	3123561	3021790	101771	3.3
27	2019	Nov	70.4	68.1	3123569	3021641	101928	3.3
27	2019	Dec	70.3	68	3123024	3021131	101893	3.3
27	2020	Jan	70.3	68.1	3122744	3023966	98778	3.2
27	2020	Feb	70.2	68.1	3121259	3025148	96111	3.1
28	2010	Jan	57.2	51	1262265	1125566	136699	10.8
28	2010	Feb	57.3	51.1	1264065	1126715	137350	10.9
28	2010	Mar	57.3	51.1	1265476	1128547	136929	10.8
28	2010	Apr	56.8	50.7	1266360	1130601	135759	10.7
28	2010	May	56.8	50.8	1266762	1132519	134243	10.6
28	2010	Jun	58.5	52.6	1306437	1173441	132996	10.2
28	2010	Jul	59.4	53.4	1326439	1193677	132762	10
28	2010	Aug	59.8	53.8	1336789	1203357	133432	10
28	2010	Sep	60	54	1342025	1207542	134483	10
28	2010	Oct	60.1	54	1344535	1209091	135444	10.1
28	2010	Nov	60.1	54	1345482	1209488	135994	10.1
28	2010	Dec	60.1	54	1345586	1209414	136172	10.1
28	2011	Jan	60	54	1345507	1209251	136256	10.1
28	2011	Feb	60	53.9	1345328	1209035	136293	10.1
28	2011	Mar	60	53.9	1344971	1208728	136243	10.1
28	2011	Apr	60	53.9	1344614	1208346	136268	10.1
28	2011	May	59.9	53.8	1344472	1208033	136439	10.1
28	2011	Jun	59.9	53.8	1344528	1207954	136574	10.2
28	2011	Jul	59.9	53.8	1344424	1208189	136235	10.1
28	2011	Aug	59.8	53.8	1343978	1208627	135351	10.1
28	2011	Sep	59.8	53.8	1343207	1209232	133975	10
28	2011	Oct	59.7	53.8	1341803	1209848	131955	9.8
28	2011	Nov	59.6	53.8	1339527	1210197	129330	9.7
28	2011	Dec	59.4	53.8	1336341	1210116	126225	9.4
28	2012	Jan	59.2	53.8	1332527	1209512	123015	9.2
28	2012	Feb	59	53.7	1328706	1208386	120320	9.1
28	2012	Mar	58.9	53.6	1325478	1206726	118752	9
28	2012	Apr	58.8	53.5	1322927	1204608	118319	8.9
28	2012	May	58.7	53.4	1321106	1202397	118709	9
28	2012	Jun	58.6	53.3	1319609	1200361	119248	9
28	2012	Jul	58.5	53.2	1317728	1198413	119315	9.1
28	2012	Aug	58.3	53.1	1315097	1196279	118818	9
28	2012	Sep	58.2	52.9	1311692	1193750	117942	9
28	2012	Oct	57.9	52.8	1307510	1190608	116902	8.9
28	2012	Nov	57.7	52.6	1302896	1186901	115995	8.9
28	2012	Dec	57.5	52.4	1298275	1182929	115346	8.9
28	2013	Jan	57.2	52.1	1292358	1177409	114949	8.9
28	2013	Feb	57	52	1288530	1173985	114545	8.9
28	2013	Mar	56.9	51.8	1285054	1171222	113832	8.9
28	2013	Apr	56.7	51.7	1281875	1169180	112695	8.8
28	2013	May	56.5	51.6	1278524	1167311	111213	8.7
28	2013	Jun	56.3	51.5	1274902	1165168	109734	8.6
28	2013	Jul	56.1	51.4	1271083	1162748	108335	8.5
28	2013	Aug	55.9	51.2	1267008	1160254	106754	8.4
28	2013	Sep	55.7	51.1	1262896	1157885	105011	8.3
28	2013	Oct	55.6	51	1259333	1155823	103510	8.2
28	2013	Nov	55.4	50.9	1256621	1154236	102385	8.1
28	2013	Dec	55.3	50.9	1254595	1153056	101539	8.1
28	2014	Jan	55.3	50.9	1255138	1154294	100844	8
28	2014	Feb	55.3	50.9	1253613	1153832	99781	8
28	2014	Mar	55.2	50.8	1252086	1153452	98634	7.9
28	2014	Apr	55.1	50.8	1250342	1152945	97397	7.8
28	2014	May	55	50.8	1248595	1152591	96004	7.7
28	2014	Jun	54.9	50.8	1247350	1152877	94473	7.6
28	2014	Jul	54.9	50.8	1246833	1153838	92995	7.5
28	2014	Aug	54.9	50.8	1247075	1155440	91635	7.3
28	2014	Sep	54.9	50.9	1247815	1157586	90229	7.2
28	2014	Oct	54.9	51	1248825	1160145	88680	7.1
28	2014	Nov	55	51.1	1249880	1162872	87008	7
28	2014	Dec	55	51.2	1251288	1165777	85511	6.8
28	2015	Jan	55.1	51.4	1252920	1168833	84087	6.7
28	2015	Feb	55.2	51.5	1255286	1172055	83231	6.6
28	2015	Mar	55.3	51.7	1257980	1175506	82474	6.6
28	2015	Apr	55.4	51.8	1260707	1179005	81702	6.5
28	2015	May	55.5	51.9	1263072	1182215	80857	6.4
28	2015	Jun	55.5	52	1264744	1184780	79964	6.3
28	2015	Jul	55.6	52.1	1265995	1186716	79279	6.3
28	2015	Aug	55.6	52.2	1267270	1188303	78967	6.2
28	2015	Sep	55.7	52.2	1268954	1189973	78981	6.2
28	2015	Oct	55.8	52.3	1271266	1192127	79139	6.2
28	2015	Nov	55.9	52.4	1273956	1194762	79194	6.2
28	2015	Dec	56	52.5	1276303	1197416	78887	6.2
28	2016	Jan	56	52.6	1277682	1199510	78172	6.1
28	2016	Feb	56	52.6	1277989	1200743	77246	6
28	2016	Mar	56	52.6	1277527	1201196	76331	6
28	2016	Apr	56	52.6	1276873	1201286	75587	5.9
28	2016	May	55.9	52.6	1276655	1201544	75111	5.9
28	2016	Jun	55.9	52.7	1277164	1202372	74792	5.9
28	2016	Jul	56	52.7	1278187	1203843	74344	5.8
28	2016	Aug	56	52.8	1279323	1205613	73710	5.8
28	2016	Sep	56	52.8	1280255	1207279	72976	5.7
28	2016	Oct	56	52.9	1280678	1208594	72084	5.6
28	2016	Nov	56	52.9	1280720	1209672	71048	5.5
28	2016	Dec	56	52.9	1280605	1210656	69949	5.5
28	2017	Jan	56	53	1280467	1211585	68882	5.4
28	2017	Feb	56	53	1280290	1212402	67888	5.3
28	2017	Mar	56	53	1279940	1212873	67067	5.2
28	2017	Apr	55.9	53	1279531	1213077	66454	5.2
28	2017	May	55.9	53	1279058	1213124	65934	5.2
28	2017	Jun	55.9	53	1278463	1213029	65434	5.1
28	2017	Jul	55.8	53	1277866	1212939	64927	5.1
28	2017	Aug	55.8	53	1277163	1212886	64277	5
28	2017	Sep	55.8	53	1276188	1212687	63501	5
28	2017	Oct	55.7	53	1274938	1212198	62740	4.9
28	2017	Nov	55.6	52.9	1273531	1211370	62161	4.9
28	2017	Dec	55.6	52.9	1272264	1210447	61817	4.9
28	2018	Jan	55.6	52.9	1271479	1209764	61715	4.9
28	2018	Feb	55.6	52.9	1271287	1209516	61771	4.9
28	2018	Mar	55.6	52.9	1271440	1209652	61788	4.9
28	2018	Apr	55.6	52.9	1271336	1209750	61586	4.8
28	2018	May	55.6	52.9	1270625	1209444	61181	4.8
28	2018	Jun	55.5	52.9	1269435	1208765	60670	4.8
28	2018	Jul	55.5	52.9	1268013	1207788	60225	4.7
28	2018	Aug	55.4	52.8	1266921	1206751	60170	4.7
28	2018	Sep	55.4	52.8	1266590	1205948	60642	4.8
28	2018	Oct	55.4	52.7	1267023	1205449	61574	4.9
28	2018	Nov	55.4	52.7	1267932	1205127	62805	5
28	2018	Dec	55.5	52.7	1268895	1204784	64111	5.1
28	2019	Jan	55.5	52.7	1269621	1204357	65264	5.1
28	2019	Feb	55.5	52.7	1270062	1203907	66155	5.2
28	2019	Mar	55.6	52.6	1270582	1203687	66895	5.3
28	2019	Apr	55.6	52.7	1271594	1203960	67634	5.3
28	2019	May	55.7	52.7	1273240	1204792	68448	5.4
28	2019	Jun	55.8	52.7	1275359	1206004	69355	5.4
28	2019	Jul	55.9	52.8	1277749	1207458	70291	5.5
28	2019	Aug	55.9	52.8	1279638	1208630	71008	5.5
28	2019	Sep	56	52.9	1280907	1209518	71389	5.6
28	2019	Oct	56	52.9	1281461	1209989	71472	5.6
28	2019	Nov	56	52.9	1281170	1209874	71296	5.6
28	2019	Dec	56	52.9	1280945	1209761	71184	5.6
28	2020	Jan	55.9	52.8	1279329	1209534	69795	5.5
28	2020	Feb	55.8	52.8	1276525	1208089	68436	5.4
29	2010	Jan	65.8	59.3	3044035	2746214	297821	9.8
29	2010	Feb	65.9	59.4	3050406	2752092	298314	9.8
29	2010	Mar	66	59.5	3055657	2758039	297618	9.7
29	2010	Apr	66.2	59.8	3058868	2763038	295830	9.7
29	2010	May	66.2	59.9	3059887	2766767	293120	9.6
29	2010	Jun	66.2	59.9	3059038	2768613	290425	9.5
29	2010	Jul	66.1	59.8	3057515	2768607	288908	9.4
29	2010	Aug	66	59.8	3056769	2767659	289110	9.5
29	2010	Sep	66	59.7	3056905	2766458	290447	9.5
29	2010	Oct	66	59.7	3057770	2766309	291461	9.5
29	2010	Nov	66	59.7	3058401	2767747	290654	9.5
29	2010	Dec	65.9	59.7	3057994	2770483	287511	9.4
29	2011	Jan	65.9	59.8	3057319	2774185	283134	9.3
29	2011	Feb	65.9	59.9	3056187	2778184	278003	9.1
29	2011	Mar	65.8	59.9	3054008	2781464	272544	8.9
29	2011	Apr	65.7	59.9	3050784	2783078	267706	8.8
29	2011	May	65.6	59.9	3047588	2783392	264196	8.7
29	2011	Jun	65.5	59.9	3045445	2783829	261616	8.6
29	2011	Jul	65.5	59.9	3044731	2785616	259115	8.5
29	2011	Aug	65.5	60	3044873	2789075	255798	8.4
29	2011	Sep	65.4	60	3044857	2794010	250847	8.2
29	2011	Oct	65.4	60.1	3044159	2799733	244426	8
29	2011	Nov	65.3	60.2	3042107	2804880	237227	7.8
29	2011	Dec	65.2	60.3	3038534	2808573	229961	7.6
29	2012	Jan	65.1	60.3	3033914	2810674	223240	7.4
29	2012	Feb	65	60.3	3029635	2811627	218008	7.2
29	2012	Mar	64.9	60.3	3026396	2811472	214924	7.1
29	2012	Apr	64.8	60.3	3023540	2810596	212944	7
29	2012	May	64.8	60.2	3021371	2810192	211179	7
29	2012	Jun	64.7	60.2	3020302	2811126	209176	6.9
29	2012	Jul	64.7	60.3	3020759	2813834	206925	6.9
29	2012	Aug	64.7	60.3	3023006	2817607	205399	6.8
29	2012	Sep	64.7	60.4	3026333	2820827	205506	6.8
29	2012	Oct	64.8	60.3	3028386	2821739	206647	6.8
29	2012	Nov	64.7	60.3	3027506	2819833	207673	6.9
29	2012	Dec	64.6	60.2	3023527	2815590	207937	6.9
29	2013	Jan	64.7	60.3	3028433	2820950	207483	6.9
29	2013	Feb	64.6	60.1	3022164	2815634	206530	6.8
29	2013	Mar	64.5	60.1	3018206	2812786	205420	6.8
29	2013	Apr	64.4	60.1	3018139	2813392	204747	6.8
29	2013	May	64.5	60.1	3020703	2816017	204686	6.8
29	2013	Jun	64.5	60.1	3023445	2818684	204761	6.8
29	2013	Jul	64.5	60.1	3024493	2820140	204353	6.8
29	2013	Aug	64.4	60.1	3022915	2820313	202602	6.7
29	2013	Sep	64.3	60.1	3020000	2820028	199972	6.6
29	2013	Oct	64.3	60.1	3018648	2820136	198512	6.6
29	2013	Nov	64.3	60.1	3020515	2821486	199029	6.6
29	2013	Dec	64.4	60.1	3025140	2824308	200832	6.6
29	2014	Jan	64.5	60.2	3030438	2827730	202708	6.7
29	2014	Feb	64.6	60.2	3035586	2832780	202806	6.7
29	2014	Mar	64.6	60.3	3039018	2838142	200876	6.6
29	2014	Apr	64.6	60.4	3040435	2843215	197220	6.5
29	2014	May	64.6	60.5	3040778	2848392	192386	6.3
29	2014	Jun	64.6	60.6	3041836	2854494	187342	6.2
29	2014	Jul	64.6	60.7	3044284	2861346	182938	6
29	2014	Aug	64.7	60.9	3048411	2868825	179586	5.9
29	2014	Sep	64.8	61	3053732	2876710	177022	5.8
29	2014	Oct	64.8	61.1	3058716	2884305	174411	5.7
29	2014	Nov	64.9	61.2	3062698	2890714	171984	5.6
29	2014	Dec	64.9	61.3	3066576	2895898	170678	5.6
29	2015	Jan	65	61.4	3070254	2899964	170290	5.5
29	2015	Feb	65.1	61.5	3074251	2903830	170421	5.5
29	2015	Mar	65.1	61.5	3077662	2907806	169856	5.5
29	2015	Apr	65.1	61.6	3079601	2912128	167473	5.4
29	2015	May	65.1	61.7	3079387	2916386	163001	5.3
29	2015	Jun	65	61.7	3077194	2919947	157247	5.1
29	2015	Jul	65	61.8	3074280	2922956	151324	4.9
29	2015	Aug	64.9	61.8	3071946	2925819	146127	4.8
29	2015	Sep	64.8	61.8	3070945	2929079	141866	4.6
29	2015	Oct	64.8	61.9	3072238	2933465	138773	4.5
29	2015	Nov	64.9	62	3075731	2938768	136963	4.5
29	2015	Dec	64.9	62.1	3079522	2943784	135738	4.4
29	2016	Jan	65	62.1	3082319	2947440	134879	4.4
29	2016	Feb	65	62.2	3083829	2949106	134723	4.4
29	2016	Mar	65	62.1	3084241	2948582	135659	4.4
29	2016	Apr	65	62.1	3084431	2946339	138092	4.5
29	2016	May	65	62	3085186	2943398	141788	4.6
29	2016	Jun	65	61.9	3086139	2940589	145550	4.7
29	2016	Jul	64.9	61.8	3086459	2938411	148048	4.8
29	2016	Aug	64.9	61.8	3085409	2936860	148549	4.8
29	2016	Sep	64.8	61.7	3082738	2935743	146995	4.8
29	2016	Oct	64.7	61.7	3078240	2934973	143267	4.7
29	2016	Nov	64.5	61.6	3072652	2935010	137642	4.5
29	2016	Dec	64.4	61.6	3067717	2936206	131511	4.3
29	2017	Jan	64.3	61.7	3064503	2938306	126197	4.1
29	2017	Feb	64.3	61.7	3062879	2941004	121875	4
29	2017	Mar	64.2	61.7	3062473	2943685	118788	3.9
29	2017	Apr	64.2	61.8	3063071	2946310	116761	3.8
29	2017	May	64.2	61.8	3064079	2948979	115100	3.8
29	2017	Jun	64.2	61.8	3064985	2951384	113601	3.7
29	2017	Jul	64.2	61.9	3065765	2953279	112486	3.7
29	2017	Aug	64.2	61.9	3065797	2954250	111547	3.6
29	2017	Sep	64.1	61.8	3064685	2954115	110570	3.6
29	2017	Oct	64.1	61.8	3062591	2953071	109520	3.6
29	2017	Nov	64	61.7	3059836	2951457	108379	3.5
29	2017	Dec	63.9	61.7	3056857	2950059	106798	3.5
29	2018	Jan	63.9	61.7	3054637	2949635	105002	3.4
29	2018	Feb	63.8	61.7	3054065	2950686	103379	3.4
29	2018	Mar	63.8	61.7	3054534	2952953	101581	3.3
29	2018	Apr	63.8	61.7	3054401	2955083	99318	3.3
29	2018	May	63.8	61.7	3053081	2956121	96960	3.2
29	2018	Jun	63.7	61.7	3050976	2956351	94625	3.1
29	2018	Jul	63.6	61.7	3048597	2956269	92328	3
29	2018	Aug	63.6	61.7	3047578	2956632	90946	3
29	2018	Sep	63.6	61.7	3049023	2957990	91033	3
29	2018	Oct	63.6	61.7	3052936	2960320	92616	3
29	2018	Nov	63.7	61.7	3058275	2963187	95088	3.1
29	2018	Dec	63.8	61.8	3063304	2965735	97569	3.2
29	2019	Jan	63.9	61.8	3066433	2967251	99182	3.2
29	2019	Feb	63.9	61.8	3066996	2967458	99538	3.2
29	2019	Mar	63.8	61.8	3066036	2967068	98968	3.2
29	2019	Apr	63.8	61.7	3065263	2967502	97761	3.2
29	2019	May	63.8	61.8	3066057	2969628	96429	3.1
29	2019	Jun	63.8	61.8	3069636	2973695	95941	3.1
29	2019	Jul	64	61.9	3077388	2980183	97205	3.2
29	2019	Aug	64.1	62.1	3087074	2987335	99739	3.2
29	2019	Sep	64.3	62.2	3096836	2994012	102824	3.3
29	2019	Oct	64.4	62.2	3104105	2998448	105657	3.4
29	2019	Nov	64.4	62.2	3105035	2998582	106453	3.4
29	2019	Dec	64.4	62.2	3104134	2997762	106372	3.4
29	2020	Jan	64.5	62.2	3111534	3001253	110281	3.5
29	2020	Feb	64.5	62.2	3111784	3002123	109661	3.5
30	2010	Jan	64.9	60.2	500111	463719	36392	7.3
30	2010	Feb	64.9	60.2	500537	463715	36822	7.4
30	2010	Mar	64.9	60.1	500852	463843	37009	7.4
30	2010	Apr	64.4	59.7	501056	464095	36961	7.4
30	2010	May	64.4	59.7	501155	464415	36740	7.3
30	2010	Jun	64.4	59.7	501110	464658	36452	7.3
30	2010	Jul	64.3	59.7	500905	464705	36200	7.2
30	2010	Aug	64.2	59.6	500619	464543	36076	7.2
30	2010	Sep	64.2	59.5	500334	464216	36118	7.2
30	2010	Oct	64.1	59.4	500103	463831	36272	7.3
30	2010	Nov	64	59.4	499959	463507	36452	7.3
30	2010	Dec	64	59.3	499925	463359	36566	7.3
30	2011	Jan	64	59.3	500012	463453	36559	7.3
30	2011	Feb	63.9	59.3	500123	463721	36402	7.3
30	2011	Mar	63.9	59.3	500168	464042	36126	7.2
30	2011	Apr	63.9	59.3	500186	464387	35799	7.2
30	2011	May	63.9	59.3	500285	464791	35494	7.1
30	2011	Jun	63.9	59.4	500562	465336	35226	7
30	2011	Jul	63.9	59.4	501016	466076	34940	7
30	2011	Aug	63.9	59.5	501574	467018	34556	6.9
30	2011	Sep	63.9	59.6	502148	468110	34038	6.8
30	2011	Oct	63.9	59.7	502636	469230	33406	6.6
30	2011	Nov	63.9	59.8	502954	470237	32717	6.5
30	2011	Dec	63.9	59.8	503131	471075	32056	6.4
30	2012	Jan	63.9	59.9	503294	471779	31515	6.3
30	2012	Feb	63.9	59.9	503616	472467	31149	6.2
30	2012	Mar	63.9	60	504198	473238	30960	6.1
30	2012	Apr	64	60.1	504977	474093	30884	6.1
30	2012	May	64.1	60.2	505872	475038	30834	6.1
30	2012	Jun	64.1	60.2	506766	476037	30729	6.1
30	2012	Jul	64.2	60.3	507498	476991	30507	6
30	2012	Aug	64.2	60.4	507991	477822	30169	5.9
30	2012	Sep	64.1	60.4	508298	478528	29770	5.9
30	2012	Oct	64.1	60.4	508529	479170	29359	5.8
30	2012	Nov	64.1	60.4	508777	479779	28998	5.7
30	2012	Dec	64.1	60.5	509093	480377	28716	5.6
30	2013	Jan	64.1	60.5	509413	480899	28514	5.6
30	2013	Feb	64.1	60.5	509850	481468	28382	5.6
30	2013	Mar	64.1	60.5	510186	481898	28288	5.5
30	2013	Apr	64	60.5	510345	482166	28179	5.5
30	2013	May	64	60.5	510327	482291	28036	5.5
30	2013	Jun	63.9	60.4	510270	482407	27863	5.5
30	2013	Jul	63.9	60.4	510389	482699	27690	5.4
30	2013	Aug	63.8	60.4	510712	483211	27501	5.4
30	2013	Sep	63.8	60.4	511146	483891	27255	5.3
30	2013	Oct	63.8	60.5	511592	484636	26956	5.3
30	2013	Nov	63.8	60.5	511924	485311	26613	5.2
30	2013	Dec	63.8	60.5	512004	485779	26225	5.1
30	2014	Jan	63.8	60.6	512419	486623	25796	5
30	2014	Feb	63.7	60.6	512047	486714	25333	4.9
30	2014	Mar	63.7	60.6	511775	486896	24879	4.9
30	2014	Apr	63.6	60.6	511753	487271	24482	4.8
30	2014	May	63.6	60.6	511978	487843	24135	4.7
30	2014	Jun	63.6	60.6	512321	488472	23849	4.7
30	2014	Jul	63.6	60.6	512578	488948	23630	4.6
30	2014	Aug	63.5	60.6	512666	489222	23444	4.6
30	2014	Sep	63.5	60.6	512662	489404	23258	4.5
30	2014	Oct	63.4	60.5	512676	489663	23013	4.5
30	2014	Nov	63.4	60.6	512874	490199	22675	4.4
30	2014	Dec	63.4	60.6	513368	491087	22281	4.3
30	2015	Jan	63.4	60.7	514152	492201	21951	4.3
30	2015	Feb	63.5	60.8	515011	493352	21659	4.2
30	2015	Mar	63.6	60.9	515785	494300	21485	4.2
30	2015	Apr	63.6	60.9	516343	494913	21430	4.2
30	2015	May	63.6	60.9	516695	495227	21468	4.2
30	2015	Jun	63.6	60.9	516971	495441	21530	4.2
30	2015	Jul	63.6	60.9	517370	495812	21558	4.2
30	2015	Aug	63.6	60.9	518002	496427	21575	4.2
30	2015	Sep	63.6	61	518785	497183	21602	4.2
30	2015	Oct	63.6	61	519628	497967	21661	4.2
30	2015	Nov	63.7	61	520439	498677	21762	4.2
30	2015	Dec	63.7	61	521130	499243	21887	4.2
30	2016	Jan	63.7	61	521657	499647	22010	4.2
30	2016	Feb	63.7	61	522007	499902	22105	4.2
30	2016	Mar	63.7	61	522190	500041	22149	4.2
30	2016	Apr	63.6	60.9	522300	500176	22124	4.2
30	2016	May	63.6	60.9	522398	500358	22040	4.2
30	2016	Jun	63.5	60.9	522465	500585	21880	4.2
30	2016	Jul	63.5	60.8	522518	500854	21664	4.1
30	2016	Aug	63.4	60.8	522601	501159	21442	4.1
30	2016	Sep	63.4	60.8	522740	501496	21244	4.1
30	2016	Oct	63.3	60.7	522905	501814	21091	4
30	2016	Nov	63.3	60.7	523088	502106	20982	4
30	2016	Dec	63.2	60.7	523331	502422	20909	4
30	2017	Jan	63.2	60.7	523682	502819	20863	4
30	2017	Feb	63.2	60.7	524142	503310	20832	4
30	2017	Mar	63.2	60.7	524653	503847	20806	4
30	2017	Apr	63.2	60.7	525152	504360	20792	4
30	2017	May	63.2	60.7	525591	504808	20783	4
30	2017	Jun	63.2	60.7	525939	505142	20797	4
30	2017	Jul	63.1	60.6	526155	505332	20823	4
30	2017	Aug	63.1	60.6	526236	505442	20794	4
30	2017	Sep	63	60.5	526271	505558	20713	3.9
30	2017	Oct	62.9	60.5	526359	505766	20593	3.9
30	2017	Nov	62.9	60.5	526503	506057	20446	3.9
30	2017	Dec	62.9	60.5	526665	506396	20269	3.8
30	2018	Jan	62.9	60.5	526863	506795	20068	3.8
30	2018	Feb	62.8	60.5	527149	507281	19868	3.8
30	2018	Mar	62.8	60.5	527522	507839	19683	3.7
30	2018	Apr	62.8	60.5	527913	508392	19521	3.7
30	2018	May	62.8	60.5	528265	508873	19392	3.7
30	2018	Jun	62.8	60.5	528573	509288	19285	3.6
30	2018	Jul	62.8	60.5	528881	509696	19185	3.6
30	2018	Aug	62.8	60.5	529238	510153	19085	3.6
30	2018	Sep	62.8	60.5	529646	510687	18959	3.6
30	2018	Oct	62.7	60.5	530058	511240	18818	3.6
30	2018	Nov	62.7	60.5	530431	511732	18699	3.5
30	2018	Dec	62.7	60.5	530733	512115	18618	3.5
30	2019	Jan	62.7	60.5	530894	512326	18568	3.5
30	2019	Feb	62.7	60.5	530934	512411	18523	3.5
30	2019	Mar	62.6	60.5	531051	512569	18482	3.5
30	2019	Apr	62.6	60.5	531418	512970	18448	3.5
30	2019	May	62.7	60.5	532100	513669	18431	3.5
30	2019	Jun	62.7	60.6	533068	514618	18450	3.5
30	2019	Jul	62.8	60.6	534199	515685	18514	3.5
30	2019	Aug	62.9	60.7	535105	516494	18611	3.5
30	2019	Sep	62.9	60.7	535725	517014	18711	3.5
30	2019	Oct	62.8	60.6	535978	517221	18757	3.5
30	2019	Nov	62.8	60.6	535823	517084	18739	3.5
30	2019	Dec	62.7	60.5	535694	516978	18716	3.5
30	2020	Jan	62.8	60.6	536520	517842	18678	3.5
30	2020	Feb	62.8	60.6	537323	518640	18683	3.5
31	2010	Jan	72.3	68.8	990571	942479	48092	4.9
31	2010	Feb	72.3	68.8	991163	943140	48023	4.8
31	2010	Mar	72.3	68.8	991850	944146	47704	4.8
31	2010	Apr	71.5	68.1	992450	945347	47103	4.7
31	2010	May	71.5	68.2	992876	946557	46319	4.7
31	2010	Jun	71.5	68.2	993203	947587	45616	4.6
31	2010	Jul	71.4	68.2	993503	948377	45126	4.5
31	2010	Aug	71.4	68.2	993853	948999	44854	4.5
31	2010	Sep	71.4	68.2	994284	949521	44763	4.5
31	2010	Oct	71.4	68.2	994820	950047	44773	4.5
31	2010	Nov	71.4	68.2	995539	950702	44837	4.5
31	2010	Dec	71.4	68.2	996477	951543	44934	4.5
31	2011	Jan	71.5	68.3	997569	952553	45016	4.5
31	2011	Feb	71.5	68.3	998640	953632	45008	4.5
31	2011	Mar	71.6	68.4	999604	954698	44906	4.5
31	2011	Apr	71.6	68.4	1000483	955737	44746	4.5
31	2011	May	71.6	68.4	1001361	956782	44579	4.5
31	2011	Jun	71.6	68.5	1002264	957893	44371	4.4
31	2011	Jul	71.7	68.5	1003308	959144	44164	4.4
31	2011	Aug	71.7	68.6	1004521	960555	43966	4.4
31	2011	Sep	71.7	68.6	1005810	962115	43695	4.3
31	2011	Oct	71.8	68.7	1007072	963766	43306	4.3
31	2011	Nov	71.8	68.8	1008200	965397	42803	4.2
31	2011	Dec	71.8	68.8	1009155	966920	42235	4.2
31	2012	Jan	71.9	68.9	1009980	968337	41643	4.1
31	2012	Feb	71.9	68.9	1010781	969660	41121	4.1
31	2012	Mar	71.9	69	1011635	970874	40761	4
31	2012	Apr	71.9	69	1012540	971999	40541	4
31	2012	May	71.9	69.1	1013516	973082	40434	4
31	2012	Jun	72	69.1	1014563	974158	40405	4
31	2012	Jul	72	69.1	1015617	975232	40385	4
31	2012	Aug	72	69.1	1016654	976300	40354	4
31	2012	Sep	72	69.2	1017753	977347	40406	4
31	2012	Oct	72	69.2	1018741	978283	40458	4
31	2012	Nov	72.1	69.2	1019439	978999	40440	4
31	2012	Dec	72	69.2	1019812	979480	40332	4
31	2013	Jan	72	69.2	1019936	979763	40173	3.9
31	2013	Feb	72	69.2	1019913	979931	39982	3.9
31	2013	Mar	72	69.1	1019828	980071	39757	3.9
31	2013	Apr	71.9	69.1	1019729	980226	39503	3.9
31	2013	May	71.9	69.1	1019559	980340	39219	3.8
31	2013	Jun	71.8	69.1	1019251	980370	38881	3.8
31	2013	Jul	71.7	69	1018741	980287	38454	3.8
31	2013	Aug	71.6	68.9	1017998	980104	37894	3.7
31	2013	Sep	71.5	68.9	1017086	979887	37199	3.7
31	2013	Oct	71.4	68.8	1016348	979736	36612	3.6
31	2013	Nov	71.3	68.8	1015997	979703	36294	3.6
31	2013	Dec	71.3	68.7	1015897	979743	36154	3.6
31	2014	Jan	71.2	68.6	1014757	978822	35935	3.5
31	2014	Feb	71.1	68.6	1014563	978828	35735	3.5
31	2014	Mar	71	68.6	1014074	978669	35405	3.5
31	2014	Apr	70.9	68.5	1013244	978319	34925	3.4
31	2014	May	70.8	68.4	1012164	977880	34284	3.4
31	2014	Jun	70.7	68.3	1011009	977472	33537	3.3
31	2014	Jul	70.6	68.3	1009947	977155	32792	3.2
31	2014	Aug	70.5	68.2	1009109	976965	32144	3.2
31	2014	Sep	70.4	68.2	1008462	976879	31583	3.1
31	2014	Oct	70.3	68.1	1007821	976836	30985	3.1
31	2014	Nov	70.2	68.1	1007099	976775	30324	3
31	2014	Dec	70.1	68	1006442	976659	29783	3
31	2015	Jan	70	68	1005660	976214	29446	2.9
31	2015	Feb	70	67.9	1005327	975984	29343	2.9
31	2015	Mar	69.9	67.9	1005252	975810	29442	2.9
31	2015	Apr	69.9	67.9	1005480	975754	29726	3
31	2015	May	69.9	67.8	1005922	975826	30096	3
31	2015	Jun	69.9	67.8	1006479	976017	30462	3
31	2015	Jul	69.9	67.8	1007090	976350	30740	3.1
31	2015	Aug	69.9	67.8	1007685	976804	30881	3.1
31	2015	Sep	69.9	67.7	1008201	977314	30887	3.1
31	2015	Oct	69.9	67.7	1008660	977838	30822	3.1
31	2015	Nov	69.8	67.7	1009071	978329	30742	3
31	2015	Dec	69.8	67.7	1009388	978736	30652	3
31	2016	Jan	69.8	67.7	1009609	979019	30590	3
31	2016	Feb	69.8	67.6	1009726	979150	30576	3
31	2016	Mar	69.7	67.6	1009703	979103	30600	3
31	2016	Apr	69.7	67.5	1009604	978924	30680	3
31	2016	May	69.6	67.5	1009547	978707	30840	3.1
31	2016	Jun	69.6	67.4	1009516	978492	31024	3.1
31	2016	Jul	69.5	67.4	1009430	978254	31176	3.1
31	2016	Aug	69.5	67.3	1009265	977964	31301	3.1
31	2016	Sep	69.4	67.2	1009081	977669	31412	3.1
31	2016	Oct	69.3	67.2	1008864	977448	31416	3.1
31	2016	Nov	69.3	67.1	1008654	977413	31241	3.1
31	2016	Dec	69.2	67.1	1008562	977642	30920	3.1
31	2017	Jan	69.2	67.1	1008670	978150	30520	3
31	2017	Feb	69.2	67.1	1008992	978897	30095	3
31	2017	Mar	69.2	67.2	1009492	979770	29722	2.9
31	2017	Apr	69.2	67.2	1010113	980653	29460	2.9
31	2017	May	69.2	67.2	1010770	981453	29317	2.9
31	2017	Jun	69.2	67.2	1011431	982150	29281	2.9
31	2017	Jul	69.2	67.2	1012125	982812	29313	2.9
31	2017	Aug	69.2	67.2	1012820	983490	29330	2.9
31	2017	Sep	69.2	67.2	1013521	984192	29329	2.9
31	2017	Oct	69.3	67.2	1014299	984933	29366	2.9
31	2017	Nov	69.3	67.3	1015169	985709	29460	2.9
31	2017	Dec	69.3	67.3	1016118	986561	29557	2.9
31	2018	Jan	69.3	67.3	1017168	987524	29644	2.9
31	2018	Feb	69.4	67.4	1018343	988614	29729	2.9
31	2018	Mar	69.4	67.4	1019584	989813	29771	2.9
31	2018	Apr	69.5	67.5	1020765	991044	29721	2.9
31	2018	May	69.5	67.5	1021856	992226	29630	2.9
31	2018	Jun	69.6	67.5	1022900	993341	29559	2.9
31	2018	Jul	69.6	67.6	1023930	994373	29557	2.9
31	2018	Aug	69.6	67.6	1025032	995357	29675	2.9
31	2018	Sep	69.6	67.6	1026227	996357	29870	2.9
31	2018	Oct	69.7	67.6	1027492	997335	30157	2.9
31	2018	Nov	69.7	67.7	1028753	998218	30535	3
31	2018	Dec	69.8	67.7	1029900	998950	30950	3
31	2019	Jan	69.8	67.7	1030858	999512	31346	3
31	2019	Feb	69.8	67.7	1031617	999943	31674	3.1
31	2019	Mar	69.9	67.7	1032289	1000359	31930	3.1
31	2019	Apr	69.9	67.7	1032977	1000895	32082	3.1
31	2019	May	69.9	67.7	1033738	1001634	32104	3.1
31	2019	Jun	69.9	67.7	1034636	1002586	32050	3.1
31	2019	Jul	69.9	67.8	1035771	1003867	31904	3.1
31	2019	Aug	70	67.8	1036782	1005104	31678	3.1
31	2019	Sep	70	67.9	1037715	1006262	31453	3
31	2019	Oct	70	67.9	1038333	1007091	31242	3
31	2019	Nov	69.9	67.8	1038315	1007168	31147	3
31	2019	Dec	69.9	67.8	1038216	1007064	31152	3
31	2020	Jan	70	67.9	1040313	1009700	30613	2.9
31	2020	Feb	70.1	68.1	1042417	1012442	29975	2.9
32	2010	Jan	67.2	58.5	1349605	1174472	175133	13
32	2010	Feb	67.3	58.4	1352271	1173869	178402	13.2
32	2010	Mar	67.3	58.4	1354628	1173685	180943	13.4
32	2010	Apr	65.4	56.6	1356407	1173783	182624	13.5
32	2010	May	65.4	56.6	1357537	1174008	183529	13.5
32	2010	Jun	65.4	56.6	1358197	1174164	184033	13.5
32	2010	Jul	65.4	56.5	1358774	1174135	184639	13.6
32	2010	Aug	65.4	56.5	1359599	1174110	185489	13.6
32	2010	Sep	65.4	56.5	1360805	1174463	186342	13.7
32	2010	Oct	65.5	56.5	1362445	1175584	186861	13.7
32	2010	Nov	65.5	56.6	1364404	1177569	186835	13.7
32	2010	Dec	65.6	56.6	1366432	1180211	186221	13.6
32	2011	Jan	65.6	56.8	1368322	1183161	185161	13.5
32	2011	Feb	65.7	56.9	1369845	1185981	183864	13.4
32	2011	Mar	65.7	57	1370856	1188271	182585	13.3
32	2011	Apr	65.7	57	1371469	1189900	181569	13.2
32	2011	May	65.7	57	1371958	1191123	180835	13.2
32	2011	Jun	65.7	57.1	1372579	1192333	180246	13.1
32	2011	Jul	65.7	57.1	1373493	1193897	179596	13.1
32	2011	Aug	65.7	57.1	1374552	1195921	178631	13
32	2011	Sep	65.6	57.2	1375393	1198323	177070	12.9
32	2011	Oct	65.5	57.2	1375745	1200974	174771	12.7
32	2011	Nov	65.4	57.2	1375441	1203644	171797	12.5
32	2011	Dec	65.3	57.3	1374611	1206169	168442	12.3
32	2012	Jan	65.2	57.3	1373690	1208579	165111	12
32	2012	Feb	65.1	57.4	1373171	1210993	162178	11.8
32	2012	Mar	65	57.4	1373279	1213419	159860	11.6
32	2012	Apr	64.9	57.5	1373957	1215881	158076	11.5
32	2012	May	64.9	57.5	1375065	1218477	156588	11.4
32	2012	Jun	64.9	57.6	1376318	1221283	155035	11.3
32	2012	Jul	64.9	57.6	1377379	1224257	153122	11.1
32	2012	Aug	64.8	57.7	1378208	1227229	150979	11
32	2012	Sep	64.8	57.8	1378948	1229993	148955	10.8
32	2012	Oct	64.7	57.8	1379538	1232349	147189	10.7
32	2012	Nov	64.6	57.8	1379951	1234261	145690	10.6
32	2012	Dec	64.6	57.8	1380159	1235804	144355	10.5
32	2013	Jan	64.5	57.8	1379414	1236301	143113	10.4
32	2013	Feb	64.4	57.8	1379565	1237734	141831	10.3
32	2013	Mar	64.4	57.8	1379976	1239648	140328	10.2
32	2013	Apr	64.3	57.9	1380739	1242168	138571	10
32	2013	May	64.3	57.9	1381585	1244919	136666	9.9
32	2013	Jun	64.2	58	1382208	1247511	134697	9.7
32	2013	Jul	64.2	58	1382407	1249781	132626	9.6
32	2013	Aug	64.1	58	1382095	1251766	130329	9.4
32	2013	Sep	63.9	58	1381434	1253656	127778	9.2
32	2013	Oct	63.8	58	1381065	1255762	125303	9.1
32	2013	Nov	63.7	58.1	1381503	1258373	123130	8.9
32	2013	Dec	63.7	58.1	1382896	1261619	121277	8.8
32	2014	Jan	63.5	58	1379343	1260310	119033	8.6
32	2014	Feb	63.5	58.1	1381570	1264204	117366	8.5
32	2014	Mar	63.5	58.2	1383581	1267875	115706	8.4
32	2014	Apr	63.5	58.2	1385086	1271134	113952	8.2
32	2014	May	63.4	58.3	1386183	1274154	112029	8.1
32	2014	Jun	63.4	58.4	1387247	1277188	110059	7.9
32	2014	Jul	63.4	58.4	1388551	1280279	108272	7.8
32	2014	Aug	63.3	58.5	1390282	1283502	106780	7.7
32	2014	Sep	63.3	58.5	1392415	1286848	105567	7.6
32	2014	Oct	63.3	58.5	1394557	1290161	104396	7.5
32	2014	Nov	63.3	58.6	1396435	1293269	103166	7.4
32	2014	Dec	63.2	58.6	1398150	1296171	101979	7.3
32	2015	Jan	63.2	58.7	1399890	1299134	100756	7.2
32	2015	Feb	63.2	58.7	1401425	1301874	99551	7.1
32	2015	Mar	63.2	58.7	1402953	1304571	98382	7
32	2015	Apr	63.1	58.8	1404463	1307118	97345	6.9
32	2015	May	63.1	58.8	1405868	1309405	96463	6.9
32	2015	Jun	63	58.8	1407100	1311456	95644	6.8
32	2015	Jul	63	58.8	1408293	1313516	94777	6.7
32	2015	Aug	62.9	58.8	1409569	1315771	93798	6.7
32	2015	Sep	62.9	58.8	1410925	1318283	92642	6.6
32	2015	Oct	62.9	58.8	1412381	1321029	91352	6.5
32	2015	Nov	62.8	58.8	1413842	1323861	89981	6.4
32	2015	Dec	62.8	58.8	1415073	1326531	88542	6.3
32	2016	Jan	62.7	58.9	1416059	1328885	87174	6.2
32	2016	Feb	62.7	58.9	1416961	1331038	85923	6.1
32	2016	Mar	62.6	58.9	1418018	1333260	84758	6
32	2016	Apr	62.6	58.9	1419439	1335810	83629	5.9
32	2016	May	62.6	58.9	1421354	1338817	82537	5.8
32	2016	Jun	62.6	59	1423662	1342159	81503	5.7
32	2016	Jul	62.6	59	1426082	1345586	80496	5.6
32	2016	Aug	62.6	59.1	1428422	1348914	79508	5.6
32	2016	Sep	62.5	59.1	1430692	1352116	78576	5.5
32	2016	Oct	62.5	59.1	1432980	1355305	77675	5.4
32	2016	Nov	62.5	59.2	1435438	1358635	76803	5.4
32	2016	Dec	62.5	59.2	1438200	1362175	76025	5.3
32	2017	Jan	62.6	59.3	1441360	1365954	75406	5.2
32	2017	Feb	62.6	59.4	1444847	1369897	74950	5.2
32	2017	Mar	62.7	59.4	1448446	1373828	74618	5.2
32	2017	Apr	62.7	59.5	1452048	1377714	74334	5.1
32	2017	May	62.8	59.6	1455550	1381585	73965	5.1
32	2017	Jun	62.8	59.7	1458918	1385459	73459	5
32	2017	Jul	62.9	59.7	1462296	1389400	72896	5
32	2017	Aug	62.9	59.8	1465727	1393376	72351	4.9
32	2017	Sep	62.9	59.8	1469187	1397325	71862	4.9
32	2017	Oct	62.9	59.9	1472724	1401245	71479	4.9
32	2017	Nov	63	59.9	1476306	1405134	71172	4.8
32	2017	Dec	63	60	1479888	1409097	70791	4.8
32	2018	Jan	63.1	60.1	1483433	1413172	70261	4.7
32	2018	Feb	63.1	60.1	1486949	1417368	69581	4.7
32	2018	Mar	63.1	60.2	1490478	1421680	68798	4.6
32	2018	Apr	63.2	60.3	1493990	1425997	67993	4.6
32	2018	May	63.2	60.4	1497541	1430270	67271	4.5
32	2018	Jun	63.3	60.5	1501256	1434602	66654	4.4
32	2018	Jul	63.3	60.5	1505142	1439024	66118	4.4
32	2018	Aug	63.4	60.6	1509203	1443506	65697	4.4
32	2018	Sep	63.4	60.7	1513349	1447976	65373	4.3
32	2018	Oct	63.5	60.8	1517345	1452274	65071	4.3
32	2018	Nov	63.5	60.8	1521037	1456325	64712	4.3
32	2018	Dec	63.6	60.9	1524369	1460108	64261	4.2
32	2019	Jan	63.6	60.9	1527359	1463652	63707	4.2
32	2019	Feb	63.6	61	1530109	1467018	63091	4.1
32	2019	Mar	63.6	61	1532838	1470330	62508	4.1
32	2019	Apr	63.6	61.1	1535719	1473763	61956	4
32	2019	May	63.6	61.1	1538795	1477371	61424	4
32	2019	Jun	63.7	61.2	1542002	1481094	60908	3.9
32	2019	Jul	63.7	61.2	1545399	1485214	60185	3.9
32	2019	Aug	63.7	61.3	1548251	1489050	59201	3.8
32	2019	Sep	63.7	61.3	1550526	1492398	58128	3.7
32	2019	Oct	63.6	61.3	1551903	1494665	57238	3.7
32	2019	Nov	63.5	61.2	1551744	1494712	57032	3.7
32	2019	Dec	63.4	61.1	1551408	1494283	57125	3.7
32	2020	Jan	63.4	61.1	1555270	1498971	56299	3.6
32	2020	Feb	63.5	61.2	1559531	1503364	56167	3.6
33	2010	Jan	69.8	65.5	740503	694080	46423	6.3
33	2010	Feb	69.8	65.5	740114	694365	45749	6.2
33	2010	Mar	69.7	65.5	739712	694801	44911	6.1
33	2010	Apr	70.3	66.1	739270	695252	44018	6
33	2010	May	70.2	66.1	738781	695590	43191	5.8
33	2010	Jun	70.1	66.1	738284	695719	42565	5.8
33	2010	Jul	70.1	66.1	737836	695646	42190	5.7
33	2010	Aug	70	66	737475	695472	42003	5.7
33	2010	Sep	69.9	65.9	737180	695336	41844	5.7
33	2010	Oct	69.8	65.9	736866	695327	41539	5.6
33	2010	Nov	69.8	65.9	736510	695498	41012	5.6
33	2010	Dec	69.7	65.9	736148	695820	40328	5.5
33	2011	Jan	69.6	65.9	735798	696173	39625	5.4
33	2011	Feb	69.6	65.9	735494	696432	39062	5.3
33	2011	Mar	69.5	65.9	735262	696494	38768	5.3
33	2011	Apr	69.5	65.8	735163	696357	38806	5.3
33	2011	May	69.4	65.7	735239	696096	39143	5.3
33	2011	Jun	69.4	65.7	735486	695842	39644	5.4
33	2011	Jul	69.4	65.6	735882	695758	40124	5.5
33	2011	Aug	69.4	65.6	736403	695970	40433	5.5
33	2011	Sep	69.4	65.6	737009	696479	40530	5.5
33	2011	Oct	69.4	65.6	737613	697158	40455	5.5
33	2011	Nov	69.4	65.6	738103	697841	40262	5.5
33	2011	Dec	69.4	65.6	738371	698353	40018	5.4
33	2012	Jan	69.4	65.6	738461	698642	39819	5.4
33	2012	Feb	69.3	65.6	738519	698761	39758	5.4
33	2012	Mar	69.3	65.6	738719	698832	39887	5.4
33	2012	Apr	69.3	65.5	739195	699024	40171	5.4
33	2012	May	69.3	65.5	739978	699439	40539	5.5
33	2012	Jun	69.4	65.5	740968	700079	40889	5.5
33	2012	Jul	69.4	65.6	741974	700822	41152	5.5
33	2012	Aug	69.5	65.6	742776	701475	41301	5.6
33	2012	Sep	69.5	65.6	743229	701908	41321	5.6
33	2012	Oct	69.4	65.6	743310	702080	41230	5.5
33	2012	Nov	69.4	65.5	743091	702013	41078	5.5
33	2012	Dec	69.3	65.5	742764	701898	40866	5.5
33	2013	Jan	69.3	65.5	742467	701920	40547	5.5
33	2013	Feb	69.2	65.5	742191	702103	40088	5.4
33	2013	Mar	69.2	65.5	741926	702439	39487	5.3
33	2013	Apr	69.1	65.5	741676	702866	38810	5.2
33	2013	May	69.1	65.5	741427	703277	38150	5.1
33	2013	Jun	69	65.5	741194	703602	37592	5.1
33	2013	Jul	68.9	65.5	741005	703834	37171	5
33	2013	Aug	68.9	65.5	740857	704023	36834	5
33	2013	Sep	68.8	65.4	740755	704241	36514	4.9
33	2013	Oct	68.8	65.4	740709	704550	36159	4.9
33	2013	Nov	68.7	65.4	740742	705001	35741	4.8
33	2013	Dec	68.7	65.4	740786	705512	35274	4.8
33	2014	Jan	68.9	65.6	743270	708392	34878	4.7
33	2014	Feb	68.8	65.7	743292	708936	34356	4.6
33	2014	Mar	68.8	65.7	743279	709442	33837	4.6
33	2014	Apr	68.7	65.7	743113	709802	33311	4.5
33	2014	May	68.7	65.6	742895	710151	32744	4.4
33	2014	Jun	68.6	65.6	742727	710602	32125	4.3
33	2014	Jul	68.6	65.7	742693	711220	31473	4.2
33	2014	Aug	68.5	65.7	742886	712048	30838	4.2
33	2014	Sep	68.5	65.8	743298	713030	30268	4.1
33	2014	Oct	68.6	65.8	743825	714068	29757	4
33	2014	Nov	68.6	65.9	744336	715053	29283	3.9
33	2014	Dec	68.6	65.9	744760	715937	28823	3.9
33	2015	Jan	68.6	66	745311	716971	28340	3.8
33	2015	Feb	68.6	66.1	745425	717598	27827	3.7
33	2015	Mar	68.6	66.1	745492	718224	27268	3.7
33	2015	Apr	68.6	66.1	745560	718910	26650	3.6
33	2015	May	68.6	66.2	745533	719539	25994	3.5
33	2015	Jun	68.5	66.2	745433	720097	25336	3.4
33	2015	Jul	68.5	66.2	745346	720643	24703	3.3
33	2015	Aug	68.4	66.2	745333	721229	24104	3.2
33	2015	Sep	68.4	66.2	745512	721983	23529	3.2
33	2015	Oct	68.4	66.3	745968	722983	22985	3.1
33	2015	Nov	68.4	66.4	746718	724223	22495	3
33	2015	Dec	68.5	66.4	747675	725600	22075	3
33	2016	Jan	68.5	66.5	748628	726884	21744	2.9
33	2016	Feb	68.5	66.6	749434	727904	21530	2.9
33	2016	Mar	68.6	66.6	750040	728596	21444	2.9
33	2016	Apr	68.6	66.6	750556	729086	21470	2.9
33	2016	May	68.6	66.6	751093	729549	21544	2.9
33	2016	Jun	68.6	66.6	751637	730044	21593	2.9
33	2016	Jul	68.6	66.6	752170	730592	21578	2.9
33	2016	Aug	68.6	66.6	752662	731153	21509	2.9
33	2016	Sep	68.5	66.6	753002	731579	21423	2.8
33	2016	Oct	68.5	66.6	753096	731748	21348	2.8
33	2016	Nov	68.4	66.5	752976	731697	21279	2.8
33	2016	Dec	68.4	66.5	752757	731555	21202	2.8
33	2017	Jan	68.3	66.4	752635	731535	21100	2.8
33	2017	Feb	68.3	66.4	752715	731771	20944	2.8
33	2017	Mar	68.3	66.4	752975	732242	20733	2.8
33	2017	Apr	68.3	66.4	753375	732862	20513	2.7
33	2017	May	68.3	66.4	753864	733522	20342	2.7
33	2017	Jun	68.3	66.4	754385	734128	20257	2.7
33	2017	Jul	68.3	66.4	754886	734628	20258	2.7
33	2017	Aug	68.3	66.4	755342	735038	20304	2.7
33	2017	Sep	68.3	66.4	755799	735450	20349	2.7
33	2017	Oct	68.3	66.4	756335	735975	20360	2.7
33	2017	Nov	68.3	66.5	756948	736606	20342	2.7
33	2017	Dec	68.3	66.5	757622	737320	20302	2.7
33	2018	Jan	68.4	66.5	758385	738133	20252	2.7
33	2018	Feb	68.4	66.6	759267	739058	20209	2.7
33	2018	Mar	68.5	66.7	760233	740073	20160	2.7
33	2018	Apr	68.5	66.7	761142	741076	20066	2.6
33	2018	May	68.6	66.8	761892	741989	19903	2.6
33	2018	Jun	68.6	66.8	762514	742836	19678	2.6
33	2018	Jul	68.6	66.8	763061	743636	19425	2.5
33	2018	Aug	68.6	66.9	763634	744434	19200	2.5
33	2018	Sep	68.6	66.9	764355	745306	19049	2.5
33	2018	Oct	68.6	66.9	765272	746283	18989	2.5
33	2018	Nov	68.7	67	766392	747376	19016	2.5
33	2018	Dec	68.8	67	767633	748524	19109	2.5
33	2019	Jan	68.8	67.1	768826	749597	19229	2.5
33	2019	Feb	68.9	67.1	769835	750494	19341	2.5
33	2019	Mar	68.9	67.2	770691	751257	19434	2.5
33	2019	Apr	69	67.2	771521	752007	19514	2.5
33	2019	May	69	67.2	772447	752848	19599	2.5
33	2019	Jun	69	67.3	773472	753774	19698	2.5
33	2019	Jul	69.1	67.3	774625	754823	19802	2.6
33	2019	Aug	69.1	67.4	775602	755721	19881	2.6
33	2019	Sep	69.1	67.4	776382	756456	19926	2.6
33	2019	Oct	69.1	67.4	776809	756871	19938	2.6
33	2019	Nov	69.1	67.3	776709	756792	19917	2.6
33	2019	Dec	69	67.3	776586	756684	19902	2.6
33	2020	Jan	69.1	67.4	778202	758262	19940	2.6
33	2020	Feb	69.2	67.4	779489	759556	19933	2.6
34	2010	Jan	67	60.4	4549452	4104096	445356	9.8
34	2010	Feb	67	60.5	4555278	4112020	443258	9.7
34	2010	Mar	67.1	60.6	4559927	4119791	440136	9.7
34	2010	Apr	66.4	60.1	4562426	4125865	436561	9.6
34	2010	May	66.4	60.1	4562235	4129579	432656	9.5
34	2010	Jun	66.3	60.1	4559450	4130185	429265	9.4
34	2010	Jul	66.2	60	4555437	4128028	427409	9.4
34	2010	Aug	66.1	59.9	4551948	4124659	427289	9.4
34	2010	Sep	66.1	59.8	4549867	4121354	428513	9.4
34	2010	Oct	66	59.8	4549879	4119800	430079	9.5
34	2010	Nov	66	59.8	4551299	4120337	430962	9.5
34	2010	Dec	66	59.8	4553174	4122269	430905	9.5
34	2011	Jan	66	59.8	4555359	4125018	430341	9.4
34	2011	Feb	66	59.8	4557018	4127495	429523	9.4
34	2011	Mar	66	59.8	4557107	4128833	428274	9.4
34	2011	Apr	66	59.8	4556028	4128987	427041	9.4
34	2011	May	65.9	59.7	4555600	4129075	426525	9.4
34	2011	Jun	65.9	59.7	4557176	4130621	426555	9.4
34	2011	Jul	65.9	59.8	4561230	4134490	426740	9.4
34	2011	Aug	66	59.8	4566927	4140177	426750	9.3
34	2011	Sep	66	59.9	4572793	4146653	426140	9.3
34	2011	Oct	66.1	59.9	4577450	4152800	424650	9.3
34	2011	Nov	66.1	60	4579959	4157197	422762	9.2
34	2011	Dec	66.1	60	4580274	4158972	421302	9.2
34	2012	Jan	66	60	4579827	4158773	421054	9.2
34	2012	Feb	66	59.9	4580547	4157820	422727	9.2
34	2012	Mar	66	59.9	4582440	4155993	426447	9.3
34	2012	Apr	66	59.8	4584234	4153426	430808	9.4
34	2012	May	66	59.8	4585463	4151747	433716	9.5
34	2012	Jun	66	59.8	4586476	4152120	434356	9.5
34	2012	Jul	66	59.8	4587732	4154797	432935	9.4
34	2012	Aug	66	59.8	4590156	4159373	430783	9.4
34	2012	Sep	66.1	59.9	4594086	4164815	429271	9.3
34	2012	Oct	66.1	59.9	4597516	4169473	428043	9.3
34	2012	Nov	66.1	59.9	4598151	4172301	425850	9.3
34	2012	Dec	66	59.9	4594449	4172901	421548	9.2
34	2013	Jan	66	60	4594280	4178849	415431	9
34	2013	Feb	65.8	60	4584049	4176045	408004	8.9
34	2013	Mar	65.7	59.9	4574555	4174535	400020	8.7
34	2013	Apr	65.6	59.9	4567974	4175392	392582	8.6
34	2013	May	65.5	59.9	4563611	4176838	386773	8.5
34	2013	Jun	65.4	59.9	4559345	4177318	382027	8.4
34	2013	Jul	65.3	59.9	4552908	4176414	376494	8.3
34	2013	Aug	65.1	59.8	4542657	4174222	368435	8.1
34	2013	Sep	64.9	59.8	4529217	4171484	357733	7.9
34	2013	Oct	64.7	59.7	4516243	4169309	346934	7.7
34	2013	Nov	64.5	59.7	4507052	4169278	337774	7.5
34	2013	Dec	64.5	59.7	4502856	4172420	330436	7.3
34	2014	Jan	63.9	59.3	4467170	4145028	322142	7.2
34	2014	Feb	64	59.4	4468826	4153001	315825	7.1
34	2014	Mar	64	59.6	4471808	4161622	310186	6.9
34	2014	Apr	64	59.7	4474887	4169393	305494	6.8
34	2014	May	64.1	59.7	4477992	4176500	301492	6.7
34	2014	Jun	64.1	59.8	4482119	4183543	298576	6.7
34	2014	Jul	64.2	59.9	4487413	4190050	297363	6.6
34	2014	Aug	64.2	60	4493750	4195985	297765	6.6
34	2014	Sep	64.3	60	4500035	4201222	298813	6.6
34	2014	Oct	64.3	60.1	4504389	4205462	298927	6.6
34	2014	Nov	64.3	60.1	4505707	4208297	297410	6.6
34	2014	Dec	64.3	60.1	4505141	4210147	294994	6.5
34	2015	Jan	64.3	60.1	4501741	4209904	291837	6.5
34	2015	Feb	64.2	60.1	4500552	4211785	288767	6.4
34	2015	Mar	64.2	60.2	4499373	4214616	284757	6.3
34	2015	Apr	64.2	60.2	4497565	4218352	279213	6.2
34	2015	May	64.1	60.2	4494259	4222145	272114	6.1
34	2015	Jun	64	60.3	4489166	4225326	263840	5.9
34	2015	Jul	63.9	60.3	4483529	4228258	255271	5.7
34	2015	Aug	63.9	60.3	4478486	4231467	247019	5.5
34	2015	Sep	63.8	60.4	4474724	4235571	239153	5.3
34	2015	Oct	63.7	60.4	4473418	4241085	232333	5.2
34	2015	Nov	63.8	60.5	4474986	4247347	227639	5.1
34	2015	Dec	63.8	60.6	4478075	4252744	225331	5
34	2016	Jan	63.8	60.6	4480839	4255861	224978	5
34	2016	Feb	63.8	60.6	4482215	4256223	225992	5
34	2016	Mar	63.8	60.6	4481577	4254203	227374	5.1
34	2016	Apr	63.8	60.5	4479689	4251164	228525	5.1
34	2016	May	63.7	60.5	4477760	4248677	229083	5.1
34	2016	Jun	63.7	60.4	4475906	4247446	228460	5.1
34	2016	Jul	63.7	60.4	4473967	4247606	226361	5.1
34	2016	Aug	63.6	60.4	4472131	4248751	223380	5
34	2016	Sep	63.6	60.4	4470616	4250177	220439	4.9
34	2016	Oct	63.5	60.4	4468604	4251355	217249	4.9
34	2016	Nov	63.4	60.4	4465906	4252582	213324	4.8
34	2016	Dec	63.4	60.4	4463317	4254125	209192	4.7
34	2017	Jan	63.3	60.4	4461746	4256013	205733	4.6
34	2017	Feb	63.3	60.4	4461245	4257961	203284	4.6
34	2017	Mar	63.3	60.5	4461144	4258943	202201	4.5
34	2017	Apr	63.3	60.4	4461194	4258672	202522	4.5
34	2017	May	63.3	60.4	4460983	4257252	203731	4.6
34	2017	Jun	63.3	60.3	4460352	4254705	205647	4.6
34	2017	Jul	63.2	60.3	4459059	4251211	207848	4.7
34	2017	Aug	63.2	60.2	4456259	4246868	209391	4.7
34	2017	Sep	63.1	60.1	4451899	4242119	209780	4.7
34	2017	Oct	63	60	4446491	4237472	209019	4.7
34	2017	Nov	62.9	60	4440412	4233062	207350	4.7
34	2017	Dec	62.8	59.9	4434158	4229695	204463	4.6
34	2018	Jan	62.7	59.9	4429148	4228216	200932	4.5
34	2018	Feb	62.7	59.9	4426833	4229220	197613	4.5
34	2018	Mar	62.7	60	4427229	4232626	194603	4.4
34	2018	Apr	62.7	60	4428470	4236980	191490	4.3
34	2018	May	62.7	60.1	4429065	4241062	188003	4.2
34	2018	Jun	62.7	60.1	4428816	4245082	183734	4.1
34	2018	Jul	62.7	60.2	4428176	4249462	178714	4
34	2018	Aug	62.7	60.2	4428823	4254763	174060	3.9
34	2018	Sep	62.7	60.3	4431853	4261271	170582	3.8
34	2018	Oct	62.8	60.4	4437542	4268824	168718	3.8
34	2018	Nov	62.9	60.5	4445042	4277081	167961	3.8
34	2018	Dec	63	60.6	4452190	4284903	167287	3.8
34	2019	Jan	63.1	60.7	4456587	4291177	165410	3.7
34	2019	Feb	63.1	60.8	4457146	4295671	161475	3.6
34	2019	Mar	63	60.8	4455781	4299568	156213	3.5
34	2019	Apr	63	60.9	4455716	4304824	150892	3.4
34	2019	May	63.1	61	4459791	4312707	147084	3.3
34	2019	Jun	63.2	61.2	4469516	4323243	146273	3.3
34	2019	Jul	63.5	61.3	4486272	4336736	149536	3.3
34	2019	Aug	63.7	61.5	4505661	4350169	155492	3.5
34	2019	Sep	64	61.7	4523734	4361752	161982	3.6
34	2019	Oct	64.1	61.8	4536222	4369115	167107	3.7
34	2019	Nov	64.1	61.7	4537131	4368963	168168	3.7
34	2019	Dec	64.1	61.7	4535046	4367342	167704	3.7
34	2020	Jan	64.3	61.9	4551684	4379423	172261	3.8
34	2020	Feb	64.5	62	4564238	4390387	173851	3.8
35	2010	Jan	61.1	56.2	933018	858746	74272	8
35	2010	Feb	61.2	56.2	934526	859339	75187	8
35	2010	Mar	61.2	56.3	936583	860436	76147	8.1
35	2010	Apr	60	55.1	938582	861587	76995	8.2
35	2010	May	60	55.1	939956	862388	77568	8.3
35	2010	Jun	60	55	940305	862544	77761	8.3
35	2010	Jul	59.9	54.9	939503	861960	77543	8.3
35	2010	Aug	59.7	54.8	937851	860864	76987	8.2
35	2010	Sep	59.5	54.7	935844	859656	76188	8.1
35	2010	Oct	59.3	54.6	933963	858795	75168	8
35	2010	Nov	59.2	54.5	932509	858547	73962	7.9
35	2010	Dec	59.1	54.5	931524	858872	72652	7.8
35	2011	Jan	59	54.5	930931	859575	71356	7.7
35	2011	Feb	58.9	54.5	930489	860328	70161	7.5
35	2011	Mar	58.9	54.5	930022	860844	69178	7.4
35	2011	Apr	58.8	54.5	929680	861100	68580	7.4
35	2011	May	58.8	54.4	929629	861139	68490	7.4
35	2011	Jun	58.7	54.4	929808	860961	68847	7.4
35	2011	Jul	58.7	54.3	930174	860671	69503	7.5
35	2011	Aug	58.7	54.3	930567	860318	70249	7.5
35	2011	Sep	58.7	54.2	930760	859914	70846	7.6
35	2011	Oct	58.6	54.2	930768	859611	71157	7.6
35	2011	Nov	58.6	54.1	930568	859530	71038	7.6
35	2011	Dec	58.5	54.1	930015	859620	70395	7.6
35	2012	Jan	58.5	54.1	929176	859841	69335	7.5
35	2012	Feb	58.4	54.1	928263	860138	68125	7.3
35	2012	Mar	58.3	54.1	927370	860339	67031	7.2
35	2012	Apr	58.2	54.1	926402	860239	66163	7.1
35	2012	May	58.2	54	925588	860026	65562	7.1
35	2012	Jun	58.1	54	925359	860128	65231	7
35	2012	Jul	58.1	54	925878	860752	65126	7
35	2012	Aug	58.2	54.1	927017	861828	65189	7
35	2012	Sep	58.2	54.1	928458	863079	65379	7
35	2012	Oct	58.3	54.1	929564	864022	65542	7.1
35	2012	Nov	58.2	54.1	929901	864319	65582	7.1
35	2012	Dec	58.2	54.1	929497	864032	65465	7
35	2013	Jan	58.1	54	928424	863259	65165	7
35	2013	Feb	58	53.9	926830	862128	64702	7
35	2013	Mar	57.9	53.9	925144	860995	64149	6.9
35	2013	Apr	57.8	53.8	923860	860204	63656	6.9
35	2013	May	57.7	53.7	923102	859685	63417	6.9
35	2013	Jun	57.7	53.7	922686	859209	63477	6.9
35	2013	Jul	57.6	53.6	922517	858771	63746	6.9
35	2013	Aug	57.6	53.6	922566	858535	64031	6.9
35	2013	Sep	57.6	53.6	922837	858644	64193	7
35	2013	Oct	57.6	53.6	923343	859094	64249	7
35	2013	Nov	57.6	53.6	923958	859733	64225	7
35	2013	Dec	57.7	53.7	924484	860377	64107	6.9
35	2014	Jan	57.9	53.9	928588	864364	64224	6.9
35	2014	Feb	57.9	53.9	928918	864967	63951	6.9
35	2014	Mar	58	54	929341	865638	63703	6.9
35	2014	Apr	58	54	929843	866347	63496	6.8
35	2014	May	58	54.1	930435	867205	63230	6.8
35	2014	Jun	58.1	54.1	931218	868364	62854	6.7
35	2014	Jul	58.1	54.2	932110	869760	62350	6.7
35	2014	Aug	58.1	54.3	932980	871255	61725	6.6
35	2014	Sep	58.2	54.4	933725	872670	61055	6.5
35	2014	Oct	58.2	54.4	934311	873866	60445	6.5
35	2014	Nov	58.2	54.4	934721	874692	60029	6.4
35	2014	Dec	58.2	54.4	934991	875050	59941	6.4
35	2015	Jan	58.2	54.5	935890	875658	60232	6.4
35	2015	Feb	58.2	54.4	935977	875304	60673	6.5
35	2015	Mar	58.2	54.4	935988	874858	61130	6.5
35	2015	Apr	58.2	54.4	935866	874479	61387	6.6
35	2015	May	58.1	54.3	935545	874207	61338	6.6
35	2015	Jun	58.1	54.3	935050	874021	61029	6.5
35	2015	Jul	58	54.3	934525	873898	60627	6.5
35	2015	Aug	58	54.2	934099	873766	60333	6.5
35	2015	Sep	57.9	54.2	933878	873670	60208	6.4
35	2015	Oct	57.9	54.2	933974	873721	60253	6.5
35	2015	Nov	57.9	54.2	934403	873952	60451	6.5
35	2015	Dec	58	54.2	935061	874336	60725	6.5
35	2016	Jan	58	54.2	935749	874748	61001	6.5
35	2016	Feb	58	54.2	936303	875026	61277	6.5
35	2016	Mar	58	54.2	936689	875097	61592	6.6
35	2016	Apr	58	54.2	936998	875018	61980	6.6
35	2016	May	58	54.1	937271	874881	62390	6.7
35	2016	Jun	58	54.1	937398	874695	62703	6.7
35	2016	Jul	58	54.1	937380	874578	62802	6.7
35	2016	Aug	57.9	54.1	937263	874625	62638	6.7
35	2016	Sep	57.9	54	937002	874751	62251	6.6
35	2016	Oct	57.8	54	936574	874883	61691	6.6
35	2016	Nov	57.8	54	936133	875127	61006	6.5
35	2016	Dec	57.7	54	935816	875553	60263	6.4
35	2017	Jan	57.7	54.1	935709	876205	59504	6.4
35	2017	Feb	57.7	54.1	935778	877084	58694	6.3
35	2017	Mar	57.7	54.1	935831	878012	57819	6.2
35	2017	Apr	57.7	54.2	935820	878905	56915	6.1
35	2017	May	57.7	54.2	935772	879750	56022	6
35	2017	Jun	57.7	54.3	935660	880499	55161	5.9
35	2017	Jul	57.6	54.3	935466	881107	54359	5.8
35	2017	Aug	57.6	54.3	935193	881605	53588	5.7
35	2017	Sep	57.5	54.3	934922	882142	52780	5.6
35	2017	Oct	57.5	54.3	934650	882801	51849	5.5
35	2017	Nov	57.4	54.3	934345	883559	50786	5.4
35	2017	Dec	57.4	54.4	934073	884438	49635	5.3
35	2018	Jan	57.4	54.4	933989	885510	48479	5.2
35	2018	Feb	57.4	54.5	934219	886811	47408	5.1
35	2018	Mar	57.4	54.6	934766	888301	46465	5
35	2018	Apr	57.4	54.6	935432	889752	45680	4.9
35	2018	May	57.5	54.7	936134	890995	45139	4.8
35	2018	Jun	57.5	54.7	936964	892093	44871	4.8
35	2018	Jul	57.5	54.8	937904	893095	44809	4.8
35	2018	Aug	57.6	54.8	938998	894054	44944	4.8
35	2018	Sep	57.6	54.8	940326	895053	45273	4.8
35	2018	Oct	57.7	54.9	941927	896179	45748	4.9
35	2018	Nov	57.7	54.9	943722	897452	46270	4.9
35	2018	Dec	57.8	55	945491	898770	46721	4.9
35	2019	Jan	57.9	55	947008	899963	47045	5
35	2019	Feb	57.9	55.1	948193	900972	47221	5
35	2019	Mar	58	55.1	949247	901992	47255	5
35	2019	Apr	58	55.2	950371	903253	47118	5
35	2019	May	58.1	55.2	951670	904857	46813	4.9
35	2019	Jun	58.2	55.3	953233	906791	46442	4.9
35	2019	Jul	58.3	55.4	955251	909143	46108	4.8
35	2019	Aug	58.3	55.5	957248	911407	45841	4.8
35	2019	Sep	58.4	55.6	959014	913337	45677	4.8
35	2019	Oct	58.4	55.7	960159	914532	45627	4.8
35	2019	Nov	58.4	55.6	960148	914468	45680	4.8
35	2019	Dec	58.4	55.6	959922	914194	45728	4.8
35	2020	Jan	58.4	55.6	961100	915430	45670	4.8
35	2020	Feb	58.4	55.6	961708	915744	45964	4.8
36	2010	Jan	62.3	56.7	9589044	8737735	851309	8.9
36	2010	Feb	62.4	56.9	9605948	8757142	848806	8.8
36	2010	Mar	62.4	57	9621227	8776986	844241	8.8
36	2010	Apr	62.8	57.3	9630479	8792421	838058	8.7
36	2010	May	62.8	57.4	9631529	8801543	829986	8.6
36	2010	Jun	62.7	57.3	9623572	8801658	821914	8.5
36	2010	Jul	62.6	57.2	9609354	8792951	816403	8.5
36	2010	Aug	62.4	57.1	9593332	8779428	813904	8.5
36	2010	Sep	62.2	57	9577587	8764345	813242	8.5
36	2010	Oct	62.1	56.8	9563891	8752287	811604	8.5
36	2010	Nov	62	56.8	9551431	8744834	806597	8.4
36	2010	Dec	61.9	56.7	9539098	8740995	798103	8.4
36	2011	Jan	61.8	56.7	9528314	8739920	788394	8.3
36	2011	Feb	61.7	56.6	9517986	8738380	779606	8.2
36	2011	Mar	61.6	56.6	9506231	8733288	772943	8.1
36	2011	Apr	61.4	56.5	9493559	8723458	770101	8.1
36	2011	May	61.3	56.3	9483635	8711503	772132	8.1
36	2011	Jun	61.3	56.3	9480227	8702587	777640	8.2
36	2011	Jul	61.3	56.2	9486165	8701473	784692	8.3
36	2011	Aug	61.3	56.2	9500945	8708594	792351	8.3
36	2011	Sep	61.4	56.3	9521336	8721554	799782	8.4
36	2011	Oct	61.6	56.3	9543711	8736516	807195	8.5
36	2011	Nov	61.6	56.4	9562510	8748504	814006	8.5
36	2011	Dec	61.7	56.4	9574444	8754959	819485	8.6
36	2012	Jan	61.7	56.4	9581121	8757122	823999	8.6
36	2012	Feb	61.7	56.4	9586612	8758084	828528	8.6
36	2012	Mar	61.7	56.4	9591657	8757816	833841	8.7
36	2012	Apr	61.7	56.3	9594584	8756373	838211	8.7
36	2012	May	61.7	56.3	9597583	8757979	839604	8.7
36	2012	Jun	61.7	56.3	9602266	8765976	836290	8.7
36	2012	Jul	61.7	56.4	9608455	8780838	827617	8.6
36	2012	Aug	61.8	56.5	9617913	8801370	816543	8.5
36	2012	Sep	61.8	56.6	9631758	8824815	806943	8.4
36	2012	Oct	61.9	56.7	9645555	8845696	799859	8.3
36	2012	Nov	61.9	56.8	9655584	8860603	794981	8.2
36	2012	Dec	61.9	56.8	9659771	8868947	790824	8.2
36	2013	Jan	61.9	56.8	9655271	8869350	785921	8.1
36	2013	Feb	61.8	56.8	9651505	8872227	779278	8.1
36	2013	Mar	61.8	56.9	9651758	8880955	770803	8
36	2013	Apr	61.8	57	9660078	8897969	762109	7.9
36	2013	May	61.9	57.1	9672985	8917413	755572	7.8
36	2013	Jun	61.9	57.1	9685182	8932756	752426	7.8
36	2013	Jul	62	57.2	9692150	8941331	750819	7.7
36	2013	Aug	61.9	57.2	9687837	8942726	745111	7.7
36	2013	Sep	61.8	57.1	9671445	8938974	732471	7.6
36	2013	Oct	61.6	57.1	9650536	8934550	715986	7.4
36	2013	Nov	61.5	57	9631855	8933068	698787	7.3
36	2013	Dec	61.4	57	9617388	8934768	682620	7.1
36	2014	Jan	61	56.7	9557444	8891979	665465	7
36	2014	Feb	60.9	56.8	9548508	8896686	651822	6.8
36	2014	Mar	60.9	56.8	9540438	8900374	640064	6.7
36	2014	Apr	60.8	56.8	9531103	8901572	629531	6.6
36	2014	May	60.7	56.8	9521124	8903144	617980	6.5
36	2014	Jun	60.7	56.8	9514317	8909035	605282	6.4
36	2014	Jul	60.6	56.8	9511481	8918415	593066	6.2
36	2014	Aug	60.6	56.9	9514182	8931022	583160	6.1
36	2014	Sep	60.6	57	9521660	8946039	575621	6
36	2014	Oct	60.7	57.1	9529358	8961204	568154	6
36	2014	Nov	60.7	57.1	9534612	8974604	560008	5.9
36	2014	Dec	60.7	57.2	9540144	8987189	552955	5.8
36	2015	Jan	60.8	57.3	9544579	8997585	546994	5.7
36	2015	Feb	60.8	57.4	9552949	9010168	542781	5.7
36	2015	Mar	60.9	57.4	9561497	9023616	537881	5.6
36	2015	Apr	60.9	57.5	9568011	9037463	530548	5.5
36	2015	May	60.9	57.6	9569402	9049193	520209	5.4
36	2015	Jun	60.9	57.6	9563755	9056618	507137	5.3
36	2015	Jul	60.8	57.7	9554722	9061246	493476	5.2
36	2015	Aug	60.7	57.7	9547385	9065479	481906	5
36	2015	Sep	60.7	57.7	9545316	9072213	473103	5
36	2015	Oct	60.8	57.8	9552323	9084409	467914	4.9
36	2015	Nov	60.8	57.9	9567364	9100847	466517	4.9
36	2015	Dec	60.9	58	9582950	9116556	466394	4.9
36	2016	Jan	61	58	9591743	9126494	465249	4.9
36	2016	Feb	61	58	9590442	9127609	462833	4.8
36	2016	Mar	60.9	58	9579507	9119809	459698	4.8
36	2016	Apr	60.8	57.9	9564084	9106300	457784	4.8
36	2016	May	60.7	57.8	9550935	9091949	458986	4.8
36	2016	Jun	60.7	57.7	9543083	9080187	462896	4.9
36	2016	Jul	60.7	57.7	9539996	9072562	467434	4.9
36	2016	Aug	60.6	57.7	9539455	9068476	470979	4.9
36	2016	Sep	60.6	57.6	9539105	9066158	472947	5
36	2016	Oct	60.6	57.6	9536267	9064636	471631	4.9
36	2016	Nov	60.6	57.6	9531775	9065980	465795	4.9
36	2016	Dec	60.6	57.7	9529163	9071509	457654	4.8
36	2017	Jan	60.6	57.7	9530913	9080374	450539	4.7
36	2017	Feb	60.7	57.8	9537224	9091221	446003	4.7
36	2017	Mar	60.7	57.9	9545838	9100810	445028	4.7
36	2017	Apr	60.8	57.9	9555504	9108274	447230	4.7
36	2017	May	60.9	58	9564471	9113926	450545	4.7
36	2017	Jun	60.9	58	9570659	9117029	453630	4.7
36	2017	Jul	60.9	58	9572659	9117049	455610	4.8
36	2017	Aug	60.9	58	9568287	9113232	455055	4.8
36	2017	Sep	60.8	57.9	9557643	9105971	451672	4.7
36	2017	Oct	60.7	57.9	9543205	9096611	446594	4.7
36	2017	Nov	60.6	57.8	9527547	9085925	441622	4.6
36	2017	Dec	60.6	57.8	9513789	9077369	436420	4.6
36	2018	Jan	60.5	57.8	9505817	9074847	430970	4.5
36	2018	Feb	60.5	57.8	9506088	9080635	425453	4.5
36	2018	Mar	60.6	57.9	9512599	9093681	418918	4.4
36	2018	Apr	60.6	58	9518802	9108362	410440	4.3
36	2018	May	60.7	58.1	9520394	9119951	400443	4.2
36	2018	Jun	60.7	58.2	9518221	9128479	389742	4.1
36	2018	Jul	60.6	58.2	9514970	9135281	379689	4
36	2018	Aug	60.7	58.3	9515399	9142250	373149	3.9
36	2018	Sep	60.7	58.3	9521482	9150233	371249	3.9
36	2018	Oct	60.8	58.4	9531730	9158403	373327	3.9
36	2018	Nov	60.8	58.4	9542679	9165087	377592	4
36	2018	Dec	60.9	58.5	9549429	9167089	382340	4
36	2019	Jan	60.9	58.4	9547462	9161783	385679	4
36	2019	Feb	60.8	58.4	9534512	9148538	385974	4
36	2019	Mar	60.7	58.3	9514746	9130757	383989	4
36	2019	Apr	60.6	58.2	9495586	9115005	380581	4
36	2019	May	60.6	58.2	9483005	9106058	376947	4
36	2019	Jun	60.6	58.2	9480192	9105741	374451	3.9
36	2019	Jul	60.6	58.2	9488460	9115194	373266	3.9
36	2019	Aug	60.7	58.3	9501909	9129585	372324	3.9
36	2019	Sep	60.8	58.4	9516997	9145414	371583	3.9
36	2019	Oct	60.9	58.5	9527899	9156652	371247	3.9
36	2019	Nov	60.9	58.5	9529070	9157857	371213	3.9
36	2019	Dec	60.9	58.5	9527712	9156258	371454	3.9
36	2020	Jan	61	58.7	9542921	9178410	364511	3.8
36	2020	Feb	61.1	58.8	9551755	9197522	354233	3.7
37	2010	Jan	64	56.7	4585775	4064556	521219	11.4
37	2010	Feb	64.2	56.9	4606035	4080476	525559	11.4
37	2010	Mar	64.4	57.1	4622114	4097183	524931	11.4
37	2010	Apr	63.5	56.3	4631285	4112003	519282	11.2
37	2010	May	63.4	56.4	4632515	4123402	509113	11
37	2010	Jun	63.2	56.4	4627292	4129971	497321	10.7
37	2010	Jul	63	56.4	4619653	4131890	487763	10.6
37	2010	Aug	62.9	56.3	4613366	4130990	482376	10.5
37	2010	Sep	62.7	56.2	4609741	4128946	480795	10.4
37	2010	Oct	62.7	56.1	4609416	4128264	481152	10.4
37	2010	Nov	62.6	56.1	4611258	4129762	481496	10.4
37	2010	Dec	62.6	56.1	4613405	4132989	480416	10.4
37	2011	Jan	62.6	56.1	4615841	4137620	478221	10.4
37	2011	Feb	62.5	56.1	4618086	4142264	475822	10.3
37	2011	Mar	62.5	56.1	4619330	4145282	474048	10.3
37	2011	Apr	62.5	56.1	4620259	4145987	474272	10.3
37	2011	May	62.4	56	4622639	4145350	477289	10.3
37	2011	Jun	62.4	55.9	4626858	4145399	481459	10.4
37	2011	Jul	62.4	55.9	4632545	4148330	484215	10.5
37	2011	Aug	62.5	55.9	4638876	4154816	484060	10.4
37	2011	Sep	62.5	56	4644899	4164506	480393	10.3
37	2011	Oct	62.5	56.1	4650085	4176228	473857	10.2
37	2011	Nov	62.5	56.2	4653103	4187931	465172	10
37	2011	Dec	62.4	56.3	4653712	4198153	455559	9.8
37	2012	Jan	62.3	56.4	4653376	4206727	446649	9.6
37	2012	Feb	62.3	56.4	4654035	4214099	439936	9.5
37	2012	Mar	62.3	56.4	4656332	4219648	436684	9.4
37	2012	Apr	62.3	56.4	4659384	4223431	435953	9.4
37	2012	May	62.3	56.4	4663979	4227719	436260	9.4
37	2012	Jun	62.3	56.5	4670723	4234462	436261	9.3
37	2012	Jul	62.3	56.5	4679032	4243930	435102	9.3
37	2012	Aug	62.4	56.6	4688766	4255583	433183	9.2
37	2012	Sep	62.5	56.8	4699769	4268377	431392	9.2
37	2012	Oct	62.6	56.8	4709793	4280257	429536	9.1
37	2012	Nov	62.6	56.9	4716950	4289646	427304	9.1
37	2012	Dec	62.6	56.9	4719804	4295807	423997	9
37	2013	Jan	62.3	56.8	4706939	4287015	419924	8.9
37	2013	Feb	62.2	56.7	4702054	4288636	413418	8.8
37	2013	Mar	62.1	56.7	4696913	4291728	405185	8.6
37	2013	Apr	62	56.8	4694011	4298091	395920	8.4
37	2013	May	61.9	56.8	4693173	4306304	386869	8.2
37	2013	Jun	61.9	56.9	4693545	4314695	378850	8.1
37	2013	Jul	61.8	56.9	4694477	4322873	371604	7.9
37	2013	Aug	61.7	56.9	4693963	4330674	363289	7.7
37	2013	Sep	61.6	57	4690536	4337411	353125	7.5
37	2013	Oct	61.5	57	4685769	4343095	342674	7.3
37	2013	Nov	61.4	57	4681782	4348539	333243	7.1
37	2013	Dec	61.3	57	4679576	4354118	325458	7
37	2014	Jan	61.2	57	4676153	4357486	318667	6.8
37	2014	Feb	61.2	57.1	4678000	4365137	312863	6.7
37	2014	Mar	61.1	57.1	4681233	4372743	308490	6.6
37	2014	Apr	61.1	57.1	4684752	4379091	305661	6.5
37	2014	May	61.1	57.2	4688207	4384962	303245	6.5
37	2014	Jun	61.1	57.2	4692464	4392084	300380	6.4
37	2014	Jul	61.1	57.2	4697035	4400328	296707	6.3
37	2014	Aug	61.1	57.3	4702276	4409779	292497	6.2
37	2014	Sep	61.1	57.4	4708604	4420712	287892	6.1
37	2014	Oct	61.1	57.4	4714927	4432433	282494	6
37	2014	Nov	61.1	57.5	4720031	4443170	276861	5.9
37	2014	Dec	61.1	57.6	4725372	4452362	273010	5.8
37	2015	Jan	61.1	57.6	4731408	4460266	271142	5.7
37	2015	Feb	61.2	57.6	4740319	4466965	273354	5.8
37	2015	Mar	61.2	57.7	4750452	4473614	276838	5.8
37	2015	Apr	61.3	57.7	4760422	4480674	279748	5.9
37	2015	May	61.4	57.7	4768384	4487508	280876	5.9
37	2015	Jun	61.3	57.7	4772869	4493230	279639	5.9
37	2015	Jul	61.3	57.7	4774945	4498453	276492	5.8
37	2015	Aug	61.2	57.7	4776483	4504148	272335	5.7
37	2015	Sep	61.2	57.8	4779107	4511413	267694	5.6
37	2015	Oct	61.2	57.8	4785180	4521814	263366	5.5
37	2015	Nov	61.2	57.9	4795756	4535703	260053	5.4
37	2015	Dec	61.3	58	4808514	4551337	257177	5.3
37	2016	Jan	61.4	58.1	4820427	4566317	254110	5.3
37	2016	Feb	61.4	58.2	4829889	4578941	250948	5.2
37	2016	Mar	61.4	58.3	4836197	4588514	247683	5.1
37	2016	Apr	61.4	58.3	4840535	4595687	244848	5.1
37	2016	May	61.4	58.3	4845206	4601914	243292	5
37	2016	Jun	61.4	58.3	4851555	4608317	243238	5
37	2016	Jul	61.4	58.4	4859953	4615733	244220	5
37	2016	Aug	61.5	58.4	4869942	4624070	245872	5
37	2016	Sep	61.5	58.4	4880584	4632733	247851	5.1
37	2016	Oct	61.6	58.4	4890145	4641160	248985	5.1
37	2016	Nov	61.6	58.5	4897719	4649715	248004	5.1
37	2016	Dec	61.6	58.5	4903564	4658756	244808	5
37	2017	Jan	61.6	58.5	4908232	4668246	239986	4.9
37	2017	Feb	61.5	58.6	4912098	4678040	234058	4.8
37	2017	Mar	61.5	58.7	4915480	4687202	228278	4.6
37	2017	Apr	61.5	58.7	4919929	4696347	223582	4.5
37	2017	May	61.5	58.8	4926285	4706367	219918	4.5
37	2017	Jun	61.5	58.8	4934301	4716865	217436	4.4
37	2017	Jul	61.6	58.9	4943175	4726877	216298	4.4
37	2017	Aug	61.6	58.9	4950706	4735061	215645	4.4
37	2017	Sep	61.6	58.9	4955417	4740683	214734	4.3
37	2017	Oct	61.5	58.9	4957257	4743871	213386	4.3
37	2017	Nov	61.4	58.8	4956898	4745105	211793	4.3
37	2017	Dec	61.3	58.7	4956077	4746307	209770	4.2
37	2018	Jan	61.3	58.7	4957181	4749545	207636	4.2
37	2018	Feb	61.3	58.7	4961922	4756173	205749	4.1
37	2018	Mar	61.3	58.8	4969833	4766016	203817	4.1
37	2018	Apr	61.3	58.9	4977177	4775695	201482	4
37	2018	May	61.3	58.9	4981319	4782348	198971	4
37	2018	Jun	61.3	58.9	4982889	4786558	196331	3.9
37	2018	Jul	61.2	58.8	4983233	4789518	193715	3.9
37	2018	Aug	61.2	58.8	4985447	4793151	192296	3.9
37	2018	Sep	61.2	58.8	4991872	4799281	192591	3.9
37	2018	Oct	61.2	58.8	5002802	4808352	194450	3.9
37	2018	Nov	61.3	58.9	5017079	4819777	197302	3.9
37	2018	Dec	61.5	59	5031958	4831516	200442	4
37	2019	Jan	61.5	59.1	5044457	4841346	203111	4
37	2019	Feb	61.6	59.1	5052626	4847960	204666	4.1
37	2019	Mar	61.6	59.1	5057506	4852162	205344	4.1
37	2019	Apr	61.6	59.1	5061879	4856683	205196	4.1
37	2019	May	61.6	59.1	5067558	4863356	204202	4
37	2019	Jun	61.6	59.2	5074835	4872346	202489	4
37	2019	Jul	61.7	59.2	5084334	4884840	199494	3.9
37	2019	Aug	61.7	59.3	5093224	4898132	195092	3.8
37	2019	Sep	61.7	59.4	5100430	4910144	190286	3.7
37	2019	Oct	61.7	59.4	5104706	4918234	186472	3.7
37	2019	Nov	61.6	59.4	5104251	4918613	185638	3.6
37	2019	Dec	61.5	59.3	5103301	4917178	186123	3.6
37	2020	Jan	61.6	59.3	5110632	4925741	184891	3.6
37	2020	Feb	61.5	59.4	5114589	4931991	182598	3.6
38	2010	Jan	73.4	70.5	372147	357286	14861	4
38	2010	Feb	73.7	70.8	373754	358981	14773	4
38	2010	Mar	73.9	71	375337	360682	14655	3.9
38	2010	Apr	72	69.2	376728	362204	14524	3.9
38	2010	May	72.2	69.4	377828	363433	14395	3.8
38	2010	Jun	72.2	69.5	378633	364357	14276	3.8
38	2010	Jul	72.3	69.6	379228	365054	14174	3.7
38	2010	Aug	72.3	69.6	379763	365670	14093	3.7
38	2010	Sep	72.3	69.6	380374	366342	14032	3.7
38	2010	Oct	72.3	69.7	381116	367162	13954	3.7
38	2010	Nov	72.4	69.8	381964	368119	13845	3.6
38	2010	Dec	72.5	69.9	382864	369132	13732	3.6
38	2011	Jan	72.5	70	383753	370131	13622	3.5
38	2011	Feb	72.6	70.1	384575	371059	13516	3.5
38	2011	Mar	72.7	70.1	385333	371889	13444	3.5
38	2011	Apr	72.7	70.2	386114	372677	13437	3.5
38	2011	May	72.8	70.3	386995	373491	13504	3.5
38	2011	Jun	72.9	70.3	387988	374372	13616	3.5
38	2011	Jul	73	70.4	389060	375345	13715	3.5
38	2011	Aug	73.1	70.5	390144	376405	13739	3.5
38	2011	Sep	73.1	70.6	391160	377505	13655	3.5
38	2011	Oct	73.2	70.6	392024	378566	13458	3.4
38	2011	Nov	73.2	70.7	392693	379527	13166	3.4
38	2011	Dec	73.2	70.8	393205	380385	12820	3.3
38	2012	Jan	73.1	70.8	393660	381180	12480	3.2
38	2012	Feb	73.1	70.8	394174	381964	12210	3.1
38	2012	Mar	73.1	70.9	394788	382755	12033	3
38	2012	Apr	73.1	70.9	395496	383552	11944	3
38	2012	May	73.1	70.9	396309	384374	11935	3
38	2012	Jun	73.2	71	397207	385218	11989	3
38	2012	Jul	73.2	71	398143	386061	12082	3
38	2012	Aug	73.2	71	399078	386881	12197	3.1
38	2012	Sep	73.2	71	399994	387687	12307	3.1
38	2012	Oct	73.2	71	400894	388519	12375	3.1
38	2012	Nov	73.2	70.9	401779	389375	12404	3.1
38	2012	Dec	73.2	70.9	402642	390233	12409	3.1
38	2013	Jan	73.1	70.8	402891	390510	12381	3.1
38	2013	Feb	73.1	70.8	403668	391355	12313	3.1
38	2013	Mar	73.1	70.8	404388	392174	12214	3
38	2013	Apr	73	70.8	405056	392959	12097	3
38	2013	May	73	70.8	405653	393686	11967	3
38	2013	Jun	72.9	70.8	406196	394364	11832	2.9
38	2013	Jul	72.8	70.7	406698	394991	11707	2.9
38	2013	Aug	72.8	70.7	407135	395535	11600	2.8
38	2013	Sep	72.7	70.6	407517	395998	11519	2.8
38	2013	Oct	72.6	70.6	407874	396414	11460	2.8
38	2013	Nov	72.6	70.6	408253	396865	11388	2.8
38	2013	Dec	72.5	70.5	408710	397430	11280	2.8
38	2014	Jan	72.4	70.4	408496	397358	11138	2.7
38	2014	Feb	72.4	70.5	409283	398255	11028	2.7
38	2014	Mar	72.5	70.6	410270	399334	10936	2.7
38	2014	Apr	72.6	70.7	411375	400499	10876	2.6
38	2014	May	72.7	70.7	412512	401649	10863	2.6
38	2014	Jun	72.7	70.8	413619	402712	10907	2.6
38	2014	Jul	72.8	70.9	414646	403648	10998	2.7
38	2014	Aug	72.8	70.9	415557	404458	11099	2.7
38	2014	Sep	72.8	70.9	416266	405103	11163	2.7
38	2014	Oct	72.8	70.8	416697	405528	11169	2.7
38	2014	Nov	72.7	70.7	416803	405688	11115	2.7
38	2014	Dec	72.5	70.6	416590	405551	11039	2.6
38	2015	Jan	72.3	70.4	415928	404928	11000	2.6
38	2015	Feb	72.1	70.2	415263	404214	11049	2.7
38	2015	Mar	71.9	69.9	414521	403334	11187	2.7
38	2015	Apr	71.6	69.7	413808	402421	11387	2.8
38	2015	May	71.4	69.4	413172	401589	11583	2.8
38	2015	Jun	71.2	69.2	412612	400901	11711	2.8
38	2015	Jul	71	69	412143	400406	11737	2.8
38	2015	Aug	70.9	68.9	411807	400103	11704	2.8
38	2015	Sep	70.9	68.9	411636	399941	11695	2.8
38	2015	Oct	70.9	68.9	411638	399835	11803	2.9
38	2015	Nov	70.9	68.9	411785	399710	12075	2.9
38	2015	Dec	71	68.9	412017	399545	12472	3
38	2016	Jan	71.1	68.8	412241	399340	12901	3.1
38	2016	Feb	71.1	68.8	412403	399138	13265	3.2
38	2016	Mar	71.1	68.8	412508	399025	13483	3.3
38	2016	Apr	71.2	68.8	412596	399083	13513	3.3
38	2016	May	71.2	68.9	412696	399332	13364	3.2
38	2016	Jun	71.2	69	412789	399704	13085	3.2
38	2016	Jul	71.2	69	412830	400070	12760	3.1
38	2016	Aug	71.2	69.1	412784	400315	12469	3
38	2016	Sep	71.2	69.1	412648	400406	12242	3
38	2016	Oct	71.2	69.1	412441	400363	12078	2.9
38	2016	Nov	71.1	69.1	412209	400270	11939	2.9
38	2016	Dec	71.1	69.1	411997	400214	11783	2.9
38	2017	Jan	71.1	69.1	411825	400253	11572	2.8
38	2017	Feb	71.1	69.1	411676	400375	11301	2.7
38	2017	Mar	71.1	69.2	411474	400473	11001	2.7
38	2017	Apr	71	69.2	411179	400441	10738	2.6
38	2017	May	71	69.1	410788	400217	10571	2.6
38	2017	Jun	70.9	69.1	410317	399784	10533	2.6
38	2017	Jul	70.8	69	409790	399175	10615	2.6
38	2017	Aug	70.7	68.8	409222	398467	10755	2.6
38	2017	Sep	70.5	68.7	408624	397731	10893	2.7
38	2017	Oct	70.4	68.5	408014	397043	10971	2.7
38	2017	Nov	70.3	68.4	407395	396404	10991	2.7
38	2017	Dec	70.2	68.3	406774	395797	10977	2.7
38	2018	Jan	70.1	68.2	406159	395224	10935	2.7
38	2018	Feb	70	68.1	405555	394685	10870	2.7
38	2018	Mar	69.8	68	404957	394168	10789	2.7
38	2018	Apr	69.7	67.9	404346	393648	10698	2.6
38	2018	May	69.6	67.8	403744	393132	10612	2.6
38	2018	Jun	69.5	67.7	403209	392679	10530	2.6
38	2018	Jul	69.4	67.6	402786	392352	10434	2.6
38	2018	Aug	69.3	67.6	402507	392194	10313	2.6
38	2018	Sep	69.3	67.5	402385	392224	10161	2.5
38	2018	Oct	69.3	67.5	402400	392421	9979	2.5
38	2018	Nov	69.3	67.6	402505	392744	9761	2.4
38	2018	Dec	69.3	67.6	402661	393123	9538	2.4
38	2019	Jan	69.3	67.7	402833	393461	9372	2.3
38	2019	Feb	69.3	67.7	403000	393695	9305	2.3
38	2019	Mar	69.3	67.7	403162	393816	9346	2.3
38	2019	Apr	69.3	67.7	403330	393862	9468	2.3
38	2019	May	69.3	67.7	403494	393870	9624	2.4
38	2019	Jun	69.3	67.7	403647	393878	9769	2.4
38	2019	Jul	69.3	67.6	403815	393961	9854	2.4
38	2019	Aug	69.3	67.6	403898	394044	9854	2.4
38	2019	Sep	69.3	67.6	403977	394189	9788	2.4
38	2019	Oct	69.2	67.6	404014	394318	9696	2.4
38	2019	Nov	69.2	67.6	403988	394349	9639	2.4
38	2019	Dec	69.2	67.5	403982	394353	9629	2.4
38	2020	Jan	69.2	67.6	404282	394947	9335	2.3
38	2020	Feb	69.2	67.7	404494	395459	9035	2.2
39	2010	Jan	65.5	58.2	5874018	5223099	650919	11.1
39	2010	Feb	65.6	58.3	5878946	5230996	647950	11
39	2010	Mar	65.5	58.4	5878360	5239969	638391	10.9
39	2010	Apr	65.5	58.6	5872041	5247840	624201	10.6
39	2010	May	65.4	58.6	5861236	5253608	607628	10.4
39	2010	Jun	65.2	58.6	5848419	5256057	592362	10.1
39	2010	Jul	65.1	58.6	5837074	5255283	581791	10
39	2010	Aug	65	58.6	5829341	5252992	576349	9.9
39	2010	Sep	64.9	58.5	5824295	5250596	573699	9.9
39	2010	Oct	64.8	58.5	5820234	5250167	570067	9.8
39	2010	Nov	64.7	58.5	5814602	5252119	562483	9.7
39	2010	Dec	64.6	58.5	5806257	5255372	550885	9.5
39	2011	Jan	64.5	58.5	5797017	5258819	538198	9.3
39	2011	Feb	64.4	58.5	5788374	5260723	527651	9.1
39	2011	Mar	64.3	58.5	5781009	5259952	521057	9
39	2011	Apr	64.3	58.5	5775861	5256742	519119	9
39	2011	May	64.2	58.4	5774028	5252741	521287	9
39	2011	Jun	64.2	58.4	5774385	5250245	524140	9.1
39	2011	Jul	64.2	58.4	5775030	5251205	523825	9.1
39	2011	Aug	64.2	58.4	5773898	5255540	518358	9
39	2011	Sep	64.1	58.5	5769214	5261969	507245	8.8
39	2011	Oct	64	58.5	5760967	5268990	491977	8.5
39	2011	Nov	63.8	58.6	5750052	5274910	475142	8.3
39	2011	Dec	63.7	58.6	5737855	5278780	459075	8
39	2012	Jan	63.6	58.6	5726309	5281141	445168	7.8
39	2012	Feb	63.5	58.6	5717633	5283067	434566	7.6
39	2012	Mar	63.4	58.6	5712035	5284062	427973	7.5
39	2012	Apr	63.3	58.6	5707355	5283236	424119	7.4
39	2012	May	63.3	58.6	5703147	5281931	421216	7.4
39	2012	Jun	63.2	58.6	5699647	5281583	418064	7.3
39	2012	Jul	63.2	58.6	5696911	5282661	414250	7.3
39	2012	Aug	63.1	58.6	5696245	5284952	411293	7.2
39	2012	Sep	63.1	58.6	5699086	5287654	411432	7.2
39	2012	Oct	63.1	58.5	5703560	5288767	414793	7.3
39	2012	Nov	63.2	58.5	5707413	5287330	420083	7.4
39	2012	Dec	63.2	58.5	5709772	5284153	425619	7.5
39	2013	Jan	63.2	58.4	5710874	5280284	430590	7.5
39	2013	Feb	63.2	58.4	5711661	5277748	433913	7.6
39	2013	Mar	63.2	58.4	5713245	5278662	434583	7.6
39	2013	Apr	63.2	58.4	5717068	5283842	433226	7.6
39	2013	May	63.2	58.4	5721942	5290204	431738	7.5
39	2013	Jun	63.2	58.5	5726408	5294634	431774	7.5
39	2013	Jul	63.2	58.5	5729085	5296371	432714	7.6
39	2013	Aug	63.2	58.4	5727598	5296246	431352	7.5
39	2013	Sep	63.1	58.4	5721899	5296165	425734	7.4
39	2013	Oct	63	58.4	5715124	5298160	416964	7.3
39	2013	Nov	62.9	58.4	5709479	5303537	405942	7.1
39	2013	Dec	62.9	58.5	5704631	5311621	393010	6.9
39	2014	Jan	62.8	58.6	5702385	5323236	379149	6.6
39	2014	Feb	62.7	58.7	5697246	5332728	364518	6.4
39	2014	Mar	62.7	58.8	5693592	5341352	352240	6.2
39	2014	Apr	62.6	58.9	5691768	5348475	343293	6
39	2014	May	62.6	58.9	5692261	5355757	336504	5.9
39	2014	Jun	62.6	59	5695866	5365244	330622	5.8
39	2014	Jul	62.7	59.1	5701831	5376512	325319	5.7
39	2014	Aug	62.7	59.2	5709359	5388778	320581	5.6
39	2014	Sep	62.8	59.3	5716109	5400643	315466	5.5
39	2014	Oct	62.8	59.4	5719019	5410057	308962	5.4
39	2014	Nov	62.8	59.4	5716727	5415040	301687	5.3
39	2014	Dec	62.7	59.4	5711628	5415759	295869	5.2
39	2015	Jan	62.6	59.4	5708153	5415427	292726	5.1
39	2015	Feb	62.6	59.4	5704245	5412504	291741	5.1
39	2015	Mar	62.6	59.4	5702389	5411497	290892	5.1
39	2015	Apr	62.5	59.4	5701740	5413145	288595	5.1
39	2015	May	62.5	59.4	5700411	5416208	284203	5
39	2015	Jun	62.5	59.4	5696864	5418766	278098	4.9
39	2015	Jul	62.4	59.4	5692230	5420280	271950	4.8
39	2015	Aug	62.3	59.4	5688561	5420997	267564	4.7
39	2015	Sep	62.3	59.4	5687967	5422086	265881	4.7
39	2015	Oct	62.3	59.4	5692968	5425494	267474	4.7
39	2015	Nov	62.4	59.5	5704311	5431999	272312	4.8
39	2015	Dec	62.6	59.5	5719018	5440497	278521	4.9
39	2016	Jan	62.7	59.6	5732680	5448886	283794	5
39	2016	Feb	62.8	59.7	5742076	5455245	286831	5
39	2016	Mar	62.8	59.7	5745542	5458418	287124	5
39	2016	Apr	62.8	59.7	5744589	5458776	285813	5
39	2016	May	62.8	59.7	5742242	5457642	284600	5
39	2016	Jun	62.7	59.6	5740347	5455998	284349	5
39	2016	Jul	62.7	59.6	5739558	5454491	285067	5
39	2016	Aug	62.7	59.5	5740581	5453338	287243	5
39	2016	Sep	62.7	59.5	5744036	5452649	291387	5.1
39	2016	Oct	62.7	59.5	5748843	5452613	296230	5.2
39	2016	Nov	62.8	59.5	5753886	5454263	299623	5.2
39	2016	Dec	62.8	59.5	5758839	5458134	300705	5.2
39	2017	Jan	62.8	59.6	5763952	5464013	299939	5.2
39	2017	Feb	62.9	59.6	5769047	5471173	297874	5.2
39	2017	Mar	62.9	59.7	5773554	5477830	295724	5.1
39	2017	Apr	62.9	59.7	5777686	5483584	294102	5.1
39	2017	May	63	59.8	5781512	5488731	292781	5.1
39	2017	Jun	63	59.8	5785124	5493398	291726	5
39	2017	Jul	63	59.8	5788356	5497817	290539	5
39	2017	Aug	63	59.8	5789224	5501447	287777	5
39	2017	Sep	62.9	59.8	5786273	5503784	282489	4.9
39	2017	Oct	62.8	59.8	5780053	5504884	275169	4.8
39	2017	Nov	62.7	59.8	5772303	5504517	267786	4.6
39	2017	Dec	62.6	59.8	5765539	5503581	261958	4.5
39	2018	Jan	62.6	59.8	5762656	5503461	259195	4.5
39	2018	Feb	62.6	59.8	5765139	5505283	259856	4.5
39	2018	Mar	62.7	59.8	5771374	5509047	262327	4.5
39	2018	Apr	62.7	59.9	5777036	5512758	264278	4.6
39	2018	May	62.8	59.9	5779646	5515053	264593	4.6
39	2018	Jun	62.7	59.9	5779539	5516710	262829	4.5
39	2018	Jul	62.7	59.9	5778266	5518711	259555	4.5
39	2018	Aug	62.7	59.9	5779120	5522416	256704	4.4
39	2018	Sep	62.7	60	5783736	5528589	255147	4.4
39	2018	Oct	62.8	60	5791192	5536571	254621	4.4
39	2018	Nov	62.9	60.1	5799083	5545158	253925	4.4
39	2018	Dec	62.9	60.2	5804145	5552187	251958	4.3
39	2019	Jan	62.9	60.2	5803806	5555676	248130	4.3
39	2019	Feb	62.8	60.2	5798120	5555168	242952	4.2
39	2019	Mar	62.7	60.2	5791235	5552692	238543	4.1
39	2019	Apr	62.7	60.1	5787762	5551351	236411	4.1
39	2019	May	62.7	60.1	5789490	5552734	236756	4.1
39	2019	Jun	62.7	60.2	5795568	5556712	238856	4.1
39	2019	Jul	62.8	60.2	5804123	5563089	241034	4.2
39	2019	Aug	62.9	60.3	5810621	5569183	241438	4.2
39	2019	Sep	62.9	60.3	5814117	5574031	240086	4.1
39	2019	Oct	62.9	60.3	5814465	5576321	238144	4.1
39	2019	Nov	62.8	60.3	5812596	5575626	236970	4.1
39	2019	Dec	62.8	60.3	5811750	5574862	236888	4.1
39	2020	Jan	62.9	60.3	5818790	5580352	238438	4.1
39	2020	Feb	63	60.4	5829061	5588266	240795	4.1
40	2010	Jan	63.2	58.7	1762129	1637478	124651	7.1
40	2010	Feb	63.2	58.8	1765089	1640106	124983	7.1
40	2010	Mar	63.3	58.8	1768033	1643404	124629	7
40	2010	Apr	62.4	58.1	1770146	1646616	123530	7
40	2010	May	62.4	58.1	1771014	1649251	121763	6.9
40	2010	Jun	62.3	58.1	1770646	1650800	119846	6.8
40	2010	Jul	62.2	58	1769672	1651238	118434	6.7
40	2010	Aug	62.1	58	1768714	1651115	117599	6.6
40	2010	Sep	62	57.9	1767697	1650791	116906	6.6
40	2010	Oct	62	57.9	1766887	1650941	115946	6.6
40	2010	Nov	61.9	57.9	1766457	1651964	114493	6.5
40	2010	Dec	61.9	57.9	1766175	1653805	112370	6.4
40	2011	Jan	61.8	58	1766062	1656299	109763	6.2
40	2011	Feb	61.8	58	1765950	1658841	107109	6.1
40	2011	Mar	61.7	58.1	1765628	1660769	104859	5.9
40	2011	Apr	61.7	58.1	1765413	1662020	103393	5.9
40	2011	May	61.7	58.1	1765957	1663035	102922	5.8
40	2011	Jun	61.7	58.1	1767483	1664294	103189	5.8
40	2011	Jul	61.7	58.1	1770025	1666276	103749	5.9
40	2011	Aug	61.8	58.2	1773419	1669161	104258	5.9
40	2011	Sep	61.9	58.2	1777402	1673050	104352	5.9
40	2011	Oct	62	58.3	1781588	1677833	103755	5.8
40	2011	Nov	62	58.5	1785444	1683016	102428	5.7
40	2011	Dec	62.1	58.6	1788652	1688127	100525	5.6
40	2012	Jan	62.2	58.7	1791292	1692991	98301	5.5
40	2012	Feb	62.2	58.9	1793798	1697668	96130	5.4
40	2012	Mar	62.2	59	1796310	1701839	94471	5.3
40	2012	Apr	62.3	59	1798586	1705050	93536	5.2
40	2012	May	62.3	59.1	1800770	1707487	93283	5.2
40	2012	Jun	62.3	59.1	1803132	1709691	93441	5.2
40	2012	Jul	62.4	59.1	1805752	1712096	93656	5.2
40	2012	Aug	62.4	59.2	1808483	1714606	93877	5.2
40	2012	Sep	62.4	59.2	1810949	1716687	94262	5.2
40	2012	Oct	62.4	59.2	1812407	1717573	94834	5.2
40	2012	Nov	62.4	59.1	1812407	1716847	95560	5.3
40	2012	Dec	62.3	59	1811131	1714754	96377	5.3
40	2013	Jan	62.1	58.8	1807341	1711853	95488	5.3
40	2013	Feb	62	58.7	1805240	1709016	96224	5.3
40	2013	Mar	61.9	58.6	1803826	1707237	96589	5.4
40	2013	Apr	61.9	58.6	1803639	1707121	96518	5.4
40	2013	May	61.8	58.5	1804215	1708011	96204	5.3
40	2013	Jun	61.8	58.5	1804808	1708896	95912	5.3
40	2013	Jul	61.8	58.5	1804774	1709059	95715	5.3
40	2013	Aug	61.7	58.4	1803680	1708323	95357	5.3
40	2013	Sep	61.6	58.3	1801696	1707017	94679	5.3
40	2013	Oct	61.4	58.2	1799409	1705549	93860	5.2
40	2013	Nov	61.3	58.2	1797259	1704363	92896	5.2
40	2013	Dec	61.2	58.1	1795219	1703571	91648	5.1
40	2014	Jan	61.2	58.1	1794594	1704523	90071	5
40	2014	Feb	61.1	58.1	1792744	1704867	87877	4.9
40	2014	Mar	61	58.1	1791189	1705585	85604	4.8
40	2014	Apr	60.9	58.1	1790041	1706533	83508	4.7
40	2014	May	60.9	58.1	1789757	1708164	81593	4.6
40	2014	Jun	60.8	58.1	1790984	1711052	79932	4.5
40	2014	Jul	60.9	58.2	1793663	1715072	78591	4.4
40	2014	Aug	61	58.3	1797684	1720105	77579	4.3
40	2014	Sep	61.1	58.5	1802671	1725867	76804	4.3
40	2014	Oct	61.2	58.6	1807931	1731847	76084	4.2
40	2014	Nov	61.3	58.8	1812911	1737409	75502	4.2
40	2014	Dec	61.5	58.9	1817675	1742235	75440	4.2
40	2015	Jan	61.5	59	1821827	1745942	75885	4.2
40	2015	Feb	61.7	59	1826108	1748834	77274	4.2
40	2015	Mar	61.7	59.1	1829902	1750933	78969	4.3
40	2015	Apr	61.8	59.1	1832855	1752373	80482	4.4
40	2015	May	61.8	59.1	1834597	1753129	81468	4.4
40	2015	Jun	61.8	59	1835021	1753194	81827	4.5
40	2015	Jul	61.7	59	1834622	1752870	81752	4.5
40	2015	Aug	61.6	58.9	1833903	1752369	81534	4.4
40	2015	Sep	61.6	58.9	1833337	1751944	81393	4.4
40	2015	Oct	61.6	58.8	1833578	1751951	81627	4.5
40	2015	Nov	61.6	58.8	1834755	1752363	82392	4.5
40	2015	Dec	61.6	58.8	1836207	1752706	83501	4.5
40	2016	Jan	61.6	58.8	1837085	1752370	84715	4.6
40	2016	Feb	61.6	58.7	1836866	1750944	85922	4.7
40	2016	Mar	61.5	58.6	1835582	1748477	87105	4.7
40	2016	Apr	61.4	58.4	1833787	1745479	88308	4.8
40	2016	May	61.3	58.3	1832047	1742616	89431	4.9
40	2016	Jun	61.2	58.2	1830671	1740451	90220	4.9
40	2016	Jul	61.2	58.2	1829904	1739397	90507	4.9
40	2016	Aug	61.2	58.1	1829689	1739407	90282	4.9
40	2016	Sep	61.1	58.1	1829619	1740019	89600	4.9
40	2016	Oct	61.1	58.1	1829179	1740737	88442	4.8
40	2016	Nov	61.1	58.2	1828368	1741517	86851	4.8
40	2016	Dec	61	58.2	1827523	1742462	85061	4.7
40	2017	Jan	61	58.2	1827099	1743751	83348	4.6
40	2017	Feb	61	58.3	1827377	1745589	81788	4.5
40	2017	Mar	61	58.3	1828311	1747876	80435	4.4
40	2017	Apr	61.1	58.4	1830043	1750709	79334	4.3
40	2017	May	61.1	58.5	1832576	1754120	78456	4.3
40	2017	Jun	61.2	58.6	1835464	1757734	77730	4.2
40	2017	Jul	61.3	58.7	1838179	1761105	77074	4.2
40	2017	Aug	61.3	58.8	1840336	1763963	76373	4.1
40	2017	Sep	61.4	58.9	1841880	1766322	75558	4.1
40	2017	Oct	61.4	58.9	1842926	1768335	74591	4
40	2017	Nov	61.4	58.9	1843553	1770004	73549	4
40	2017	Dec	61.4	59	1843994	1771551	72443	3.9
40	2018	Jan	61.4	59	1844534	1773283	71251	3.9
40	2018	Feb	61.4	59.1	1845258	1775321	69937	3.8
40	2018	Mar	61.4	59.1	1845872	1777502	68370	3.7
40	2018	Apr	61.4	59.2	1845634	1779199	66435	3.6
40	2018	May	61.3	59.2	1844224	1779946	64278	3.5
40	2018	Jun	61.2	59.1	1842004	1779858	62146	3.4
40	2018	Jul	61.1	59.1	1839436	1779201	60235	3.3
40	2018	Aug	61	59	1837189	1778274	58915	3.2
40	2018	Sep	60.9	59	1835780	1777348	58432	3.2
40	2018	Oct	60.8	58.9	1835349	1776637	58712	3.2
40	2018	Nov	60.8	58.9	1835734	1776335	59399	3.2
40	2018	Dec	60.8	58.8	1836478	1776433	60045	3.3
40	2019	Jan	60.8	58.8	1837017	1776712	60305	3.3
40	2019	Feb	60.8	58.8	1837111	1777026	60085	3.3
40	2019	Mar	60.8	58.8	1837004	1777425	59579	3.2
40	2019	Apr	60.7	58.8	1837101	1778063	59038	3.2
40	2019	May	60.7	58.8	1837778	1779004	58774	3.2
40	2019	Jun	60.7	58.8	1839224	1780170	59054	3.2
40	2019	Jul	60.8	58.8	1841427	1781526	59901	3.3
40	2019	Aug	60.8	58.8	1843446	1782527	60919	3.3
40	2019	Sep	60.8	58.8	1845138	1783397	61741	3.3
40	2019	Oct	60.8	58.8	1846046	1783842	62204	3.4
40	2019	Nov	60.8	58.7	1845800	1783677	62123	3.4
40	2019	Dec	60.7	58.7	1845530	1783548	61982	3.4
40	2020	Jan	60.7	58.7	1845422	1784815	60607	3.3
40	2020	Feb	60.6	58.7	1844281	1785884	58397	3.2
41	2010	Jan	65	57.9	1967463	1752287	215176	10.9
41	2010	Feb	65.1	58	1972219	1756351	215868	10.9
41	2010	Mar	65.2	58.1	1976473	1760547	215926	10.9
41	2010	Apr	65.5	58.3	1979679	1764584	215095	10.9
41	2010	May	65.5	58.4	1981748	1768359	213389	10.8
41	2010	Jun	65.5	58.5	1983223	1771808	211415	10.7
41	2010	Jul	65.5	58.5	1984774	1774965	209809	10.6
41	2010	Aug	65.4	58.6	1986782	1778138	208644	10.5
41	2010	Sep	65.5	58.6	1989230	1781560	207670	10.4
41	2010	Oct	65.5	58.7	1991833	1785539	206294	10.4
41	2010	Nov	65.5	58.8	1994009	1790046	203963	10.2
41	2010	Dec	65.5	58.9	1995337	1794730	200607	10.1
41	2011	Jan	65.4	59	1995928	1799192	196736	9.9
41	2011	Feb	65.4	59	1995957	1802805	193152	9.7
41	2011	Mar	65.3	59.1	1995613	1805065	190548	9.5
41	2011	Apr	65.2	59	1995145	1805872	189273	9.5
41	2011	May	65.1	59	1994847	1805535	189312	9.5
41	2011	Jun	65.1	58.9	1994642	1804653	189989	9.5
41	2011	Jul	65	58.8	1994457	1804031	190426	9.5
41	2011	Aug	64.9	58.7	1994112	1803997	190115	9.5
41	2011	Sep	64.8	58.7	1993268	1804394	188874	9.5
41	2011	Oct	64.7	58.7	1991813	1804859	186954	9.4
41	2011	Nov	64.6	58.6	1989605	1804848	184757	9.3
41	2011	Dec	64.5	58.5	1986580	1804002	182578	9.2
41	2012	Jan	64.3	58.4	1982713	1802207	180506	9.1
41	2012	Feb	64.1	58.3	1978231	1799565	178666	9
41	2012	Mar	63.9	58.2	1973317	1796114	177203	9
41	2012	Apr	63.7	58	1967875	1791931	175944	8.9
41	2012	May	63.4	57.8	1962194	1787555	174639	8.9
41	2012	Jun	63.2	57.6	1956474	1783319	173155	8.9
41	2012	Jul	63	57.4	1950606	1779137	171469	8.8
41	2012	Aug	62.7	57.2	1944745	1774907	169838	8.7
41	2012	Sep	62.5	57.1	1939239	1770720	168519	8.7
41	2012	Oct	62.3	56.9	1933900	1766539	167361	8.7
41	2012	Nov	62	56.7	1928581	1762465	166116	8.6
41	2012	Dec	61.8	56.5	1923380	1758815	164565	8.6
41	2013	Jan	61.6	56.4	1918564	1755911	162653	8.5
41	2013	Feb	61.5	56.3	1914533	1754171	160362	8.4
41	2013	Mar	61.3	56.3	1911585	1753830	157755	8.3
41	2013	Apr	61.3	56.3	1909970	1754910	155060	8.1
41	2013	May	61.2	56.3	1909278	1756713	152565	8
41	2013	Jun	61.1	56.3	1908985	1758586	150399	7.9
41	2013	Jul	61.1	56.3	1908801	1760355	148446	7.8
41	2013	Aug	61	56.3	1908410	1762092	146318	7.7
41	2013	Sep	60.9	56.3	1907949	1763894	144055	7.6
41	2013	Oct	60.9	56.3	1908135	1765905	142230	7.5
41	2013	Nov	60.8	56.3	1909513	1768430	141083	7.4
41	2013	Dec	60.9	56.4	1912046	1771555	140491	7.3
41	2014	Jan	61	56.5	1917578	1776888	140690	7.3
41	2014	Feb	61.1	56.6	1921448	1781627	139821	7.3
41	2014	Mar	61.1	56.7	1925161	1786730	138431	7.2
41	2014	Apr	61.2	56.8	1928463	1791853	136610	7.1
41	2014	May	61.2	56.9	1931550	1797101	134449	7
41	2014	Jun	61.2	57.1	1934959	1802732	132227	6.8
41	2014	Jul	61.3	57.2	1938696	1808486	130210	6.7
41	2014	Aug	61.3	57.3	1942628	1814176	128452	6.6
41	2014	Sep	61.4	57.4	1946418	1819691	126727	6.5
41	2014	Oct	61.4	57.5	1949453	1824864	124589	6.4
41	2014	Nov	61.4	57.5	1951316	1829375	121941	6.2
41	2014	Dec	61.3	57.6	1952579	1833334	119245	6.1
41	2015	Jan	61.3	57.6	1953568	1836649	116919	6
41	2015	Feb	61.3	57.7	1955891	1840534	115357	5.9
41	2015	Mar	61.3	57.7	1959313	1844888	114425	5.8
41	2015	Apr	61.4	57.8	1963714	1849906	113808	5.8
41	2015	May	61.5	57.9	1968658	1855485	113173	5.7
41	2015	Jun	61.5	58	1973643	1861429	112214	5.7
41	2015	Jul	61.6	58.1	1978665	1867764	110901	5.6
41	2015	Aug	61.6	58.2	1983882	1874540	109342	5.5
41	2015	Sep	61.7	58.4	1989537	1881908	107629	5.4
41	2015	Oct	61.8	58.5	1996251	1890275	105976	5.3
41	2015	Nov	61.9	58.7	2004236	1899646	104590	5.2
41	2015	Dec	62.1	58.9	2012757	1909296	103461	5.1
41	2016	Jan	62.2	59.1	2020960	1918358	102602	5.1
41	2016	Feb	62.4	59.2	2028317	1926180	102137	5
41	2016	Mar	62.4	59.3	2034536	1932529	102007	5
41	2016	Apr	62.5	59.4	2039723	1937623	102100	5
41	2016	May	62.5	59.4	2044195	1942015	102180	5
41	2016	Jun	62.5	59.4	2048199	1946308	101891	5
41	2016	Jul	62.5	59.5	2051899	1951011	100888	4.9
41	2016	Aug	62.5	59.5	2055195	1956069	99126	4.8
41	2016	Sep	62.5	59.6	2057956	1961147	96809	4.7
41	2016	Oct	62.5	59.7	2060099	1965957	94142	4.6
41	2016	Nov	62.5	59.7	2062092	1970720	91372	4.4
41	2016	Dec	62.5	59.8	2064658	1975823	88835	4.3
41	2017	Jan	62.5	59.9	2068179	1981334	86845	4.2
41	2017	Feb	62.6	60	2072672	1987188	85484	4.1
41	2017	Mar	62.7	60.1	2077839	1993011	84828	4.1
41	2017	Apr	62.8	60.2	2083300	1998465	84835	4.1
41	2017	May	62.8	60.3	2088485	2003240	85245	4.1
41	2017	Jun	62.9	60.3	2092727	2006925	85802	4.1
41	2017	Jul	62.9	60.3	2095682	2009373	86309	4.1
41	2017	Aug	62.9	60.3	2097392	2010789	86603	4.1
41	2017	Sep	62.8	60.2	2098221	2011532	86689	4.1
41	2017	Oct	62.8	60.2	2098442	2011793	86649	4.1
41	2017	Nov	62.7	60.1	2098180	2011586	86594	4.1
41	2017	Dec	62.6	60	2097630	2011131	86499	4.1
41	2018	Jan	62.5	60	2097096	2010773	86323	4.1
41	2018	Feb	62.5	59.9	2096731	2010720	86011	4.1
41	2018	Mar	62.4	59.9	2096318	2010909	85409	4.1
41	2018	Apr	62.3	59.8	2095429	2010989	84440	4
41	2018	May	62.2	59.8	2094131	2010772	83359	4
41	2018	Jun	62.1	59.7	2093119	2010549	82570	3.9
41	2018	Jul	62.1	59.6	2092913	2010555	82358	3.9
41	2018	Aug	62	59.6	2094044	2011103	82941	4
41	2018	Sep	62	59.6	2096605	2012385	84220	4
41	2018	Oct	62.1	59.5	2100148	2014284	85864	4.1
41	2018	Nov	62.1	59.6	2103843	2016433	87410	4.2
41	2018	Dec	62.2	59.6	2106704	2018316	88388	4.2
41	2019	Jan	62.2	59.5	2107966	2019483	88483	4.2
41	2019	Feb	62.1	59.5	2107405	2019776	87629	4.2
41	2019	Mar	62	59.5	2105727	2019569	86158	4.1
41	2019	Apr	61.9	59.4	2103937	2019541	84396	4
41	2019	May	61.8	59.4	2102670	2020170	82500	3.9
41	2019	Jun	61.7	59.4	2102160	2021645	80515	3.8
41	2019	Jul	61.7	59.4	2102460	2024262	78198	3.7
41	2019	Aug	61.6	59.4	2102758	2027120	75638	3.6
41	2019	Sep	61.5	59.4	2103078	2029880	73198	3.5
41	2019	Oct	61.5	59.4	2103183	2031830	71353	3.4
41	2019	Nov	61.4	59.4	2103089	2032001	71088	3.4
41	2019	Dec	61.4	59.3	2103105	2031743	71362	3.4
41	2020	Jan	61.4	59.3	2104158	2034344	69814	3.3
41	2020	Feb	61.3	59.3	2105464	2036408	69056	3.3
42	2010	Jan	63.8	58.2	6354075	5801663	552412	8.7
42	2010	Feb	63.9	58.3	6367507	5809093	558414	8.8
42	2010	Mar	64	58.4	6379694	5819200	560494	8.8
42	2010	Apr	63.5	58	6388079	5830330	557749	8.7
42	2010	May	63.5	58.1	6391191	5841003	550188	8.6
42	2010	Jun	63.5	58.1	6389281	5848796	540485	8.5
42	2010	Jul	63.4	58.1	6385131	5852928	532203	8.3
42	2010	Aug	63.3	58.1	6381818	5854796	527022	8.3
42	2010	Sep	63.3	58.1	6380096	5855882	524214	8.2
42	2010	Oct	63.3	58.1	6380163	5858306	521857	8.2
42	2010	Nov	63.2	58.1	6380798	5862475	518323	8.1
42	2010	Dec	63.2	58.1	6380401	5867689	512712	8
42	2011	Jan	63.2	58.2	6379705	5873507	506198	7.9
42	2011	Feb	63.2	58.2	6379241	5878342	500899	7.9
42	2011	Mar	63.1	58.2	6378192	5880105	498087	7.8
42	2011	Apr	63.1	58.2	6377273	5878324	498949	7.8
42	2011	May	63.1	58.1	6378414	5874930	503484	7.9
42	2011	Jun	63.1	58.1	6382416	5872911	509505	8
42	2011	Jul	63.1	58.1	6389493	5875164	514329	8
42	2011	Aug	63.2	58.1	6398775	5882243	516532	8.1
42	2011	Sep	63.3	58.2	6408564	5893142	515422	8
42	2011	Oct	63.3	58.3	6417731	5906149	511582	8
42	2011	Nov	63.4	58.4	6424755	5918716	506039	7.9
42	2011	Dec	63.4	58.5	6428949	5928933	500016	7.8
42	2012	Jan	63.4	58.5	6431325	5936304	495021	7.7
42	2012	Feb	63.4	58.6	6434181	5941533	492648	7.7
42	2012	Mar	63.5	58.6	6438829	5944629	494200	7.7
42	2012	Apr	63.5	58.6	6444694	5945882	498812	7.7
42	2012	May	63.6	58.6	6452177	5947225	504952	7.8
42	2012	Jun	63.6	58.6	6461050	5950592	510458	7.9
42	2012	Jul	63.7	58.7	6469778	5956532	513246	7.9
42	2012	Aug	63.8	58.7	6478052	5964269	513783	7.9
42	2012	Sep	63.8	58.8	6486259	5972524	513735	7.9
42	2012	Oct	63.9	58.8	6492311	5978763	513548	7.9
42	2012	Nov	63.9	58.8	6494440	5981227	513213	7.9
42	2012	Dec	63.8	58.8	6492123	5979822	512301	7.9
42	2013	Jan	63.8	58.8	6485609	5975489	510120	7.9
42	2013	Feb	63.7	58.7	6476720	5970873	505847	7.8
42	2013	Mar	63.6	58.7	6468145	5968960	499185	7.7
42	2013	Apr	63.5	58.7	6462138	5971194	490944	7.6
42	2013	May	63.5	58.7	6457576	5974768	482808	7.5
42	2013	Jun	63.4	58.7	6452910	5976455	476455	7.4
42	2013	Jul	63.3	58.7	6446904	5974715	472189	7.3
42	2013	Aug	63.2	58.6	6437449	5970378	467071	7.3
42	2013	Sep	63.1	58.6	6424324	5965324	459000	7.1
42	2013	Oct	62.9	58.5	6411110	5962001	449109	7
42	2013	Nov	62.8	58.5	6401238	5962844	438394	6.8
42	2013	Dec	62.8	58.6	6395638	5968052	427586	6.7
42	2014	Jan	62.7	58.6	6390718	5974568	416150	6.5
42	2014	Feb	62.7	58.7	6390130	5984257	405873	6.4
42	2014	Mar	62.7	58.8	6390445	5993141	397304	6.2
42	2014	Apr	62.7	58.8	6389690	5999356	390334	6.1
42	2014	May	62.6	58.9	6387859	6004290	383569	6
42	2014	Jun	62.6	58.9	6386672	6010539	376133	5.9
42	2014	Jul	62.6	59	6386798	6018503	368295	5.8
42	2014	Aug	62.6	59.1	6389457	6028063	361394	5.7
42	2014	Sep	62.6	59.2	6394458	6038377	356081	5.6
42	2014	Oct	62.7	59.2	6399147	6047558	351589	5.5
42	2014	Nov	62.7	59.3	6401135	6053488	347647	5.4
42	2014	Dec	62.7	59.3	6401465	6056206	345259	5.4
42	2015	Jan	62.7	59.3	6399152	6054716	344436	5.4
42	2015	Feb	62.7	59.3	6401333	6055615	345718	5.4
42	2015	Mar	62.7	59.3	6405295	6058467	346828	5.4
42	2015	Apr	62.8	59.4	6410460	6063733	346727	5.4
42	2015	May	62.8	59.4	6414874	6069891	344983	5.4
42	2015	Jun	62.8	59.5	6416605	6074841	341764	5.3
42	2015	Jul	62.8	59.5	6416096	6078208	337888	5.3
42	2015	Aug	62.8	59.5	6414557	6080455	334102	5.2
42	2015	Sep	62.8	59.5	6413808	6082884	330924	5.2
42	2015	Oct	62.8	59.6	6416898	6087539	329359	5.1
42	2015	Nov	62.9	59.6	6425117	6094701	330416	5.1
42	2015	Dec	63	59.7	6436000	6102351	333649	5.2
42	2016	Jan	63.1	59.8	6445838	6107965	337873	5.2
42	2016	Feb	63.1	59.8	6452328	6110021	342307	5.3
42	2016	Mar	63.1	59.8	6454582	6108468	346114	5.4
42	2016	Apr	63.1	59.7	6453865	6104727	349138	5.4
42	2016	May	63.1	59.7	6452585	6101029	351556	5.4
42	2016	Jun	63.1	59.6	6451948	6098796	353152	5.5
42	2016	Jul	63.1	59.6	6451697	6098351	353346	5.5
42	2016	Aug	63.1	59.6	6451194	6098909	352285	5.5
42	2016	Sep	63	59.6	6449916	6099486	350430	5.4
42	2016	Oct	63	59.6	6447013	6099457	347556	5.4
42	2016	Nov	62.9	59.6	6443076	6099876	343200	5.3
42	2016	Dec	62.9	59.6	6439878	6101979	337899	5.2
42	2017	Jan	62.9	59.6	6438537	6105806	332731	5.2
42	2017	Feb	62.9	59.7	6438587	6110693	327894	5.1
42	2017	Mar	62.9	59.7	6438280	6114675	323605	5
42	2017	Apr	62.9	59.7	6436939	6117208	319731	5
42	2017	May	62.8	59.8	6433906	6118328	315578	4.9
42	2017	Jun	62.8	59.7	6429454	6117991	311463	4.8
42	2017	Jul	62.7	59.7	6424959	6116627	308332	4.8
42	2017	Aug	62.7	59.7	6420622	6114524	306098	4.8
42	2017	Sep	62.6	59.6	6416554	6112224	304330	4.7
42	2017	Oct	62.6	59.6	6412816	6110386	302430	4.7
42	2017	Nov	62.5	59.6	6409039	6108932	300107	4.7
42	2017	Dec	62.5	59.6	6405191	6108667	296524	4.6
42	2018	Jan	62.4	59.6	6402605	6110928	291677	4.6
42	2018	Feb	62.4	59.6	6403044	6116640	286404	4.5
42	2018	Mar	62.5	59.7	6406524	6125296	281228	4.4
42	2018	Apr	62.5	59.8	6410857	6134305	276552	4.3
42	2018	May	62.5	59.9	6414949	6141775	273174	4.3
42	2018	Jun	62.6	59.9	6419058	6148154	270904	4.2
42	2018	Jul	62.6	60	6423003	6154096	268907	4.2
42	2018	Aug	62.6	60	6428005	6160593	267412	4.2
42	2018	Sep	62.7	60.1	6434391	6168060	266331	4.1
42	2018	Oct	62.7	60.1	6441664	6176061	265603	4.1
42	2018	Nov	62.8	60.2	6448723	6183700	265023	4.1
42	2018	Dec	62.8	60.3	6453700	6189089	264611	4.1
42	2019	Jan	62.8	60.3	6455146	6190720	264426	4.1
42	2019	Feb	62.8	60.3	6452662	6188346	264316	4.1
42	2019	Mar	62.8	60.2	6449431	6184335	265096	4.1
42	2019	Apr	62.8	60.2	6449195	6182165	267030	4.1
42	2019	May	62.8	60.2	6454236	6183946	270290	4.2
42	2019	Jun	62.9	60.3	6465538	6190327	275211	4.3
42	2019	Jul	63.1	60.4	6484491	6202028	282463	4.4
42	2019	Aug	63.3	60.5	6505764	6215256	290508	4.5
42	2019	Sep	63.5	60.6	6525482	6227604	297878	4.6
42	2019	Oct	63.6	60.6	6539128	6235732	303396	4.6
42	2019	Nov	63.6	60.6	6540059	6235989	304070	4.6
42	2019	Dec	63.6	60.6	6537907	6234518	303389	4.6
42	2020	Jan	63.7	60.7	6549144	6242115	307029	4.7
42	2020	Feb	63.8	60.8	6558209	6249326	308883	4.7
44	2010	Jan	67.1	59.7	566147	503346	62801	11.1
44	2010	Feb	67.1	59.7	566578	503581	62997	11.1
44	2010	Mar	67.2	59.7	567057	503755	63302	11.2
44	2010	Apr	67.5	60	567548	503899	63649	11.2
44	2010	May	67.5	59.9	567916	503983	63933	11.3
44	2010	Jun	67.5	59.9	568033	503956	64077	11.3
44	2010	Jul	67.4	59.8	567869	503804	64065	11.3
44	2010	Aug	67.3	59.8	567424	503510	63914	11.3
44	2010	Sep	67.2	59.7	566704	503057	63647	11.2
44	2010	Oct	67.1	59.6	565780	502465	63315	11.2
44	2010	Nov	67	59.5	564740	501809	62931	11.1
44	2010	Dec	66.8	59.4	563679	501190	62489	11.1
44	2011	Jan	66.7	59.4	562727	500696	62031	11
44	2011	Feb	66.6	59.3	561956	500342	61614	11
44	2011	Mar	66.5	59.3	561290	500025	61265	10.9
44	2011	Apr	66.5	59.2	560646	499638	61008	10.9
44	2011	May	66.4	59.2	560052	499151	60901	10.9
44	2011	Jun	66.3	59.1	559558	498569	60989	10.9
44	2011	Jul	66.3	59	559187	497918	61269	11
44	2011	Aug	66.2	58.9	558961	497262	61699	11
44	2011	Sep	66.2	58.8	558926	496721	62205	11.1
44	2011	Oct	66.1	58.7	559077	496418	62659	11.2
44	2011	Nov	66.1	58.7	559300	496393	62907	11.2
44	2011	Dec	66.1	58.7	559436	496594	62842	11.2
44	2012	Jan	66.1	58.7	559376	496950	62426	11.2
44	2012	Feb	66.1	58.8	559086	497366	61720	11
44	2012	Mar	66	58.8	558645	497791	60854	10.9
44	2012	Apr	65.9	58.8	558234	498266	59968	10.7
44	2012	May	65.9	58.9	558003	498852	59151	10.6
44	2012	Jun	65.8	58.9	557986	499563	58423	10.5
44	2012	Jul	65.8	59	558147	500419	57728	10.3
44	2012	Aug	65.8	59.1	558414	501417	56997	10.2
44	2012	Sep	65.8	59.2	558651	502462	56189	10.1
44	2012	Oct	65.8	59.3	558715	503422	55293	9.9
44	2012	Nov	65.8	59.4	558557	504183	54374	9.7
44	2012	Dec	65.7	59.4	558181	504668	53513	9.6
44	2013	Jan	65.7	59.4	557653	504878	52775	9.5
44	2013	Feb	65.6	59.4	557115	504900	52215	9.4
44	2013	Mar	65.5	59.4	556680	504832	51848	9.3
44	2013	Apr	65.5	59.4	556398	504748	51650	9.3
44	2013	May	65.5	59.4	556300	504724	51576	9.3
44	2013	Jun	65.5	59.4	556409	504847	51562	9.3
44	2013	Jul	65.5	59.4	556682	505112	51570	9.3
44	2013	Aug	65.5	59.4	556982	505429	51553	9.3
44	2013	Sep	65.5	59.4	557190	505754	51436	9.2
44	2013	Oct	65.5	59.4	557269	506084	51185	9.2
44	2013	Nov	65.4	59.5	557240	506472	50768	9.1
44	2013	Dec	65.4	59.5	557167	507012	50155	9
44	2014	Jan	65.5	59.7	558138	508797	49341	8.8
44	2014	Feb	65.5	59.8	557926	509607	48319	8.7
44	2014	Mar	65.4	59.9	557675	510558	47117	8.4
44	2014	Apr	65.4	60	557385	511571	45814	8.2
44	2014	May	65.3	60.1	557041	512556	44485	8
44	2014	Jun	65.3	60.2	556644	513458	43186	7.8
44	2014	Jul	65.2	60.3	556231	514293	41938	7.5
44	2014	Aug	65.1	60.4	555912	515156	40756	7.3
44	2014	Sep	65.1	60.4	555710	516056	39654	7.1
44	2014	Oct	65	60.5	555568	516910	38658	7
44	2014	Nov	65	60.6	555424	517652	37772	6.8
44	2014	Dec	65	60.7	555298	518282	37016	6.7
44	2015	Jan	65	60.7	555165	518752	36413	6.6
44	2015	Feb	65	60.8	555238	519298	35940	6.5
44	2015	Mar	65	60.8	555376	519874	35502	6.4
44	2015	Apr	65	60.9	555442	520457	34985	6.3
44	2015	May	65	61	555324	520997	34327	6.2
44	2015	Jun	64.9	61	554996	521442	33554	6
44	2015	Jul	64.8	61	554507	521766	32741	5.9
44	2015	Aug	64.8	61	553938	521967	31971	5.8
44	2015	Sep	64.7	61	553433	522123	31310	5.7
44	2015	Oct	64.6	61	553167	522374	30793	5.6
44	2015	Nov	64.6	61.1	553188	522760	30428	5.5
44	2015	Dec	64.6	61.1	553375	523181	30194	5.5
44	2016	Jan	64.6	61.1	553553	523523	30030	5.4
44	2016	Feb	64.6	61.1	553657	523745	29912	5.4
44	2016	Mar	64.6	61.1	553684	523860	29824	5.4
44	2016	Apr	64.6	61.1	553676	523921	29755	5.4
44	2016	May	64.6	61.1	553680	523987	29693	5.4
44	2016	Jun	64.6	61.1	553669	524110	29559	5.3
44	2016	Jul	64.6	61.1	553569	524307	29262	5.3
44	2016	Aug	64.5	61.2	553355	524592	28763	5.2
44	2016	Sep	64.5	61.2	553057	524972	28085	5.1
44	2016	Oct	64.4	61.2	552689	525405	27284	4.9
44	2016	Nov	64.4	61.3	552313	525857	26456	4.8
44	2016	Dec	64.3	61.3	552018	526332	25686	4.7
44	2017	Jan	64.3	61.4	551878	526824	25054	4.5
44	2017	Feb	64.3	61.4	551909	527291	24618	4.5
44	2017	Mar	64.3	61.5	552083	527711	24372	4.4
44	2017	Apr	64.4	61.5	552359	528108	24251	4.4
44	2017	May	64.4	61.6	552663	528476	24187	4.4
44	2017	Jun	64.4	61.6	552966	528797	24169	4.4
44	2017	Jul	64.4	61.6	553296	529098	24198	4.4
44	2017	Aug	64.4	61.6	553598	529353	24245	4.4
44	2017	Sep	64.5	61.6	553818	529523	24295	4.4
44	2017	Oct	64.4	61.6	553970	529640	24330	4.4
44	2017	Nov	64.4	61.6	554085	529752	24333	4.4
44	2017	Dec	64.4	61.6	554218	529947	24271	4.4
44	2018	Jan	64.5	61.6	554379	530280	24099	4.3
44	2018	Feb	64.5	61.7	554530	530755	23775	4.3
44	2018	Mar	64.5	61.7	554642	531319	23323	4.2
44	2018	Apr	64.5	61.8	554697	531888	22809	4.1
44	2018	May	64.4	61.8	554686	532394	22292	4
44	2018	Jun	64.4	61.9	554610	532782	21828	3.9
44	2018	Jul	64.4	61.9	554488	533016	21472	3.9
44	2018	Aug	64.3	61.9	554421	533169	21252	3.8
44	2018	Sep	64.3	61.9	554473	533351	21122	3.8
44	2018	Oct	64.3	61.9	554613	533598	21015	3.8
44	2018	Nov	64.3	61.9	554770	533898	20872	3.8
44	2018	Dec	64.3	61.9	554849	534176	20673	3.7
44	2019	Jan	64.3	61.9	554803	534352	20451	3.7
44	2019	Feb	64.3	61.9	554644	534394	20250	3.7
44	2019	Mar	64.2	61.9	554436	534318	20118	3.6
44	2019	Apr	64.2	61.9	554273	534209	20064	3.6
44	2019	May	64.2	61.9	554268	534212	20056	3.6
44	2019	Jun	64.2	61.9	554515	534489	20026	3.6
44	2019	Jul	64.3	62	555092	535185	19907	3.6
44	2019	Aug	64.3	62	555753	536052	19701	3.5
44	2019	Sep	64.4	62.1	556431	536955	19476	3.5
44	2019	Oct	64.4	62.2	556922	537609	19313	3.5
44	2019	Nov	64.4	62.2	556972	537676	19296	3.5
44	2019	Dec	64.4	62.1	556912	537582	19330	3.5
44	2020	Jan	64.4	62.2	557583	538637	18946	3.4
44	2020	Feb	64.5	62.3	558452	539685	18767	3.4
45	2010	Jan	61.1	53.9	2145645	1894376	251269	11.7
45	2010	Feb	61.1	54	2149682	1898964	250718	11.7
45	2010	Mar	61.2	54.1	2152972	1904386	248586	11.5
45	2010	Apr	60.4	53.5	2155305	1909849	245456	11.4
45	2010	May	60.4	53.6	2156277	1914770	241507	11.2
45	2010	Jun	60.3	53.7	2156087	1918470	237617	11
45	2010	Jul	60.3	53.7	2155664	1920713	234951	10.9
45	2010	Aug	60.2	53.7	2155740	1921853	233887	10.8
45	2010	Sep	60.2	53.6	2156437	1922440	233997	10.9
45	2010	Oct	60.2	53.6	2157730	1923333	234397	10.9
45	2010	Nov	60.1	53.6	2159330	1925054	234276	10.8
45	2010	Dec	60.1	53.6	2161062	1927611	233451	10.8
45	2011	Jan	60.2	53.7	2163248	1930858	232390	10.7
45	2011	Feb	60.2	53.8	2165830	1934318	231512	10.7
45	2011	Mar	60.2	53.8	2168282	1937403	230879	10.6
45	2011	Apr	60.2	53.8	2170590	1939862	230728	10.6
45	2011	May	60.3	53.9	2173259	1941840	231419	10.6
45	2011	Jun	60.3	53.9	2176264	1943742	232522	10.7
45	2011	Jul	60.3	53.9	2179012	1945895	233117	10.7
45	2011	Aug	60.3	53.9	2180986	1948447	232539	10.7
45	2011	Sep	60.3	53.9	2181994	1951575	230419	10.6
45	2011	Oct	60.2	54	2182409	1955385	227024	10.4
45	2011	Nov	60.2	54	2182445	1959639	222806	10.2
45	2011	Dec	60.1	54.1	2182210	1963918	218292	10
45	2012	Jan	60	54.2	2182119	1968013	214106	9.8
45	2012	Feb	60	54.2	2182773	1971778	210995	9.7
45	2012	Mar	60	54.2	2184266	1974823	209443	9.6
45	2012	Apr	60	54.2	2185696	1977014	208682	9.5
45	2012	May	59.9	54.2	2186565	1978892	207673	9.5
45	2012	Jun	59.9	54.3	2186785	1981245	205540	9.4
45	2012	Jul	59.8	54.3	2186911	1984885	202026	9.2
45	2012	Aug	59.8	54.4	2187515	1989646	197869	9
45	2012	Sep	59.7	54.4	2188492	1994465	194027	8.9
45	2012	Oct	59.7	54.5	2188992	1998136	190856	8.7
45	2012	Nov	59.6	54.5	2188449	1999979	188470	8.6
45	2012	Dec	59.5	54.4	2186741	2000091	186650	8.5
45	2013	Jan	59.6	54.6	2194191	2009163	185028	8.4
45	2013	Feb	59.5	54.5	2191419	2008325	183094	8.4
45	2013	Mar	59.4	54.5	2189284	2008920	180364	8.2
45	2013	Apr	59.3	54.5	2188745	2011747	176998	8.1
45	2013	May	59.3	54.6	2189813	2016341	173472	7.9
45	2013	Jun	59.2	54.6	2191736	2021573	170163	7.8
45	2013	Jul	59.2	54.7	2193371	2026367	167004	7.6
45	2013	Aug	59.2	54.8	2193690	2030507	163183	7.4
45	2013	Sep	59.1	54.8	2192758	2034334	158424	7.2
45	2013	Oct	59	54.8	2191562	2038170	153392	7
45	2013	Nov	58.9	54.9	2191109	2042499	148610	6.8
45	2013	Dec	58.8	54.9	2191798	2047455	144343	6.6
45	2014	Jan	58.8	55	2192798	2052126	140672	6.4
45	2014	Feb	58.8	55.1	2195471	2057451	138020	6.3
45	2014	Mar	58.8	55.2	2199502	2062513	136989	6.2
45	2014	Apr	58.9	55.2	2204642	2066823	137819	6.3
45	2014	May	59	55.2	2210578	2070652	139926	6.3
45	2014	Jun	59.1	55.3	2217336	2074712	142624	6.4
45	2014	Jul	59.2	55.3	2224689	2079282	145407	6.5
45	2014	Aug	59.3	55.4	2232423	2084528	147895	6.6
45	2014	Sep	59.4	55.5	2239966	2090391	149575	6.7
45	2014	Oct	59.5	55.5	2246285	2096431	149854	6.7
45	2014	Nov	59.5	55.6	2250696	2101881	148815	6.6
45	2014	Dec	59.5	55.7	2253791	2106459	147332	6.5
45	2015	Jan	59.6	55.8	2260386	2113892	146494	6.5
45	2015	Feb	59.6	55.8	2263178	2117582	145596	6.4
45	2015	Mar	59.6	55.8	2266055	2121533	144522	6.4
45	2015	Apr	59.6	55.9	2268702	2126010	142692	6.3
45	2015	May	59.6	55.9	2270840	2130771	140069	6.2
45	2015	Jun	59.5	55.9	2272322	2135392	136930	6
45	2015	Jul	59.5	56	2273546	2139834	133712	5.9
45	2015	Aug	59.4	56	2275005	2144099	130906	5.8
45	2015	Sep	59.4	56.1	2276928	2148296	128632	5.6
45	2015	Oct	59.4	56.1	2279762	2152707	127055	5.6
45	2015	Nov	59.4	56.1	2283650	2157415	126235	5.5
45	2015	Dec	59.4	56.2	2287732	2162132	125600	5.5
45	2016	Jan	59.4	56.2	2291091	2166397	124694	5.4
45	2016	Feb	59.4	56.2	2293423	2169928	123495	5.4
45	2016	Mar	59.4	56.2	2294748	2172723	122025	5.3
45	2016	Apr	59.3	56.2	2295683	2175240	120443	5.2
45	2016	May	59.3	56.2	2296654	2177878	118776	5.2
45	2016	Jun	59.2	56.2	2297516	2180630	116886	5.1
45	2016	Jul	59.1	56.2	2298185	2183470	114715	5
45	2016	Aug	59.1	56.2	2298778	2186259	112519	4.9
45	2016	Sep	59	56.2	2299557	2188857	110700	4.8
45	2016	Oct	58.9	56.1	2300329	2191210	109119	4.7
45	2016	Nov	58.9	56.1	2300988	2193555	107433	4.7
45	2016	Dec	58.8	56.1	2301759	2196060	105699	4.6
45	2017	Jan	58.8	56.1	2302787	2198812	103975	4.5
45	2017	Feb	58.7	56.1	2303971	2201818	102153	4.4
45	2017	Mar	58.7	56.1	2305250	2204694	100556	4.4
45	2017	Apr	58.7	56.1	2306727	2207324	99403	4.3
45	2017	May	58.6	56.1	2308547	2209859	98688	4.3
45	2017	Jun	58.6	56.1	2310850	2212394	98456	4.3
45	2017	Jul	58.6	56.1	2313304	2214704	98600	4.3
45	2017	Aug	58.6	56.1	2315408	2216712	98696	4.3
45	2017	Sep	58.6	56.1	2317122	2218754	98368	4.2
45	2017	Oct	58.5	56.1	2318668	2221181	97487	4.2
45	2017	Nov	58.5	56.1	2320154	2224179	95975	4.1
45	2017	Dec	58.5	56.1	2321646	2228024	93622	4
45	2018	Jan	58.4	56.2	2323502	2232819	90683	3.9
45	2018	Feb	58.4	56.2	2325939	2238369	87570	3.8
45	2018	Mar	58.4	56.3	2328663	2244195	84468	3.6
45	2018	Apr	58.4	56.4	2331110	2249393	81717	3.5
45	2018	May	58.4	56.4	2333214	2253422	79792	3.4
45	2018	Jun	58.4	56.4	2335368	2256694	78674	3.4
45	2018	Jul	58.4	56.4	2338109	2260018	78091	3.3
45	2018	Aug	58.4	56.5	2341903	2264006	77897	3.3
45	2018	Sep	58.4	56.5	2346596	2268697	77899	3.3
45	2018	Oct	58.5	56.6	2351941	2273860	78081	3.3
45	2018	Nov	58.6	56.6	2357630	2279069	78561	3.3
45	2018	Dec	58.6	56.7	2363064	2283671	79393	3.4
45	2019	Jan	58.7	56.7	2367422	2287166	80256	3.4
45	2019	Feb	58.7	56.7	2370060	2289490	80570	3.4
45	2019	Mar	58.6	56.7	2371243	2291362	79881	3.4
45	2019	Apr	58.6	56.7	2371542	2293871	77671	3.3
45	2019	May	58.5	56.7	2371610	2297752	73858	3.1
45	2019	Jun	58.4	56.7	2372211	2303048	69163	2.9
45	2019	Jul	58.4	56.8	2374220	2309920	64300	2.7
45	2019	Aug	58.4	56.9	2376923	2316783	60140	2.5
45	2019	Sep	58.4	57	2380292	2322842	57450	2.4
45	2019	Oct	58.4	57	2383056	2326812	56244	2.4
45	2019	Nov	58.3	56.9	2383533	2326821	56712	2.4
45	2019	Dec	58.2	56.8	2383297	2326018	57279	2.4
45	2020	Jan	58.3	56.9	2387096	2330497	56599	2.4
45	2020	Feb	58.3	56.9	2391831	2333217	58614	2.5
46	2010	Jan	71.1	67.4	441836	419084	22752	5.1
46	2010	Feb	71	67.3	441620	418975	22645	5.1
46	2010	Mar	70.9	67.3	441460	419069	22391	5.1
46	2010	Apr	71.6	68	441349	419274	22075	5
46	2010	May	71.6	68	441263	419478	21785	4.9
46	2010	Jun	71.5	68	441191	419615	21576	4.9
46	2010	Jul	71.4	67.9	441139	419657	21482	4.9
46	2010	Aug	71.3	67.9	441133	419628	21505	4.9
46	2010	Sep	71.3	67.8	441175	419549	21626	4.9
46	2010	Oct	71.2	67.7	441234	419429	21805	4.9
46	2010	Nov	71.2	67.6	441279	419273	22006	5
46	2010	Dec	71.1	67.6	441300	419108	22192	5
46	2011	Jan	71.1	67.5	441272	418997	22275	5
46	2011	Feb	71	67.4	441179	418972	22207	5
46	2011	Mar	70.9	67.4	441026	419051	21975	5
46	2011	Apr	70.9	67.4	440858	419228	21630	4.9
46	2011	May	70.8	67.4	440727	419481	21246	4.8
46	2011	Jun	70.7	67.4	440642	419761	20881	4.7
46	2011	Jul	70.7	67.4	440627	420059	20568	4.7
46	2011	Aug	70.6	67.3	440691	420389	20302	4.6
46	2011	Sep	70.5	67.3	440813	420740	20073	4.6
46	2011	Oct	70.4	67.3	440931	421072	19859	4.5
46	2011	Nov	70.4	67.3	441021	421389	19632	4.5
46	2011	Dec	70.3	67.2	441098	421695	19403	4.4
46	2012	Jan	70.3	67.2	441209	422007	19202	4.4
46	2012	Feb	70.2	67.2	441386	422317	19069	4.3
46	2012	Mar	70.2	67.2	441604	422584	19020	4.3
46	2012	Apr	70.2	67.1	441843	422801	19042	4.3
46	2012	May	70.1	67.1	442106	422989	19117	4.3
46	2012	Jun	70.1	67	442401	423183	19218	4.3
46	2012	Jul	70.1	67	442705	423437	19268	4.4
46	2012	Aug	70	67	442971	423775	19196	4.3
46	2012	Sep	70	67	443188	424200	18988	4.3
46	2012	Oct	69.9	67	443337	424686	18651	4.2
46	2012	Nov	69.9	67	443353	425088	18265	4.1
46	2012	Dec	69.8	67	443215	425308	17907	4
46	2013	Jan	69.7	66.9	442860	425254	17606	4
46	2013	Feb	69.6	66.9	442604	425231	17373	3.9
46	2013	Mar	69.5	66.8	442425	425222	17203	3.9
46	2013	Apr	69.5	66.8	442384	425312	17072	3.9
46	2013	May	69.4	66.7	442478	425520	16958	3.8
46	2013	Jun	69.4	66.7	442689	425837	16852	3.8
46	2013	Jul	69.3	66.7	442951	426207	16744	3.8
46	2013	Aug	69.3	66.7	443230	426610	16620	3.7
46	2013	Sep	69.3	66.8	443529	427061	16468	3.7
46	2013	Oct	69.3	66.8	443854	427557	16297	3.7
46	2013	Nov	69.4	66.8	444225	428094	16131	3.6
46	2013	Dec	69.4	66.9	444624	428645	15979	3.6
46	2014	Jan	69.4	66.9	445072	429208	15864	3.6
46	2014	Feb	69.4	67	445400	429618	15782	3.5
46	2014	Mar	69.4	67	445688	429987	15701	3.5
46	2014	Apr	69.4	67	445936	430343	15593	3.5
46	2014	May	69.4	67	446170	430747	15423	3.5
46	2014	Jun	69.4	67	446417	431207	15210	3.4
46	2014	Jul	69.4	67.1	446714	431682	15032	3.4
46	2014	Aug	69.4	67.1	447072	432127	14945	3.3
46	2014	Sep	69.4	67.1	447431	432494	14937	3.3
46	2014	Oct	69.4	67.1	447762	432790	14972	3.3
46	2014	Nov	69.4	67.1	448053	433078	14975	3.3
46	2014	Dec	69.5	67.1	448322	433416	14906	3.3
46	2015	Jan	69.5	67.2	448587	433802	14785	3.3
46	2015	Feb	69.5	67.2	448926	434288	14638	3.3
46	2015	Mar	69.5	67.3	449292	434793	14499	3.2
46	2015	Apr	69.6	67.3	449621	435239	14382	3.2
46	2015	May	69.5	67.3	449854	435572	14282	3.2
46	2015	Jun	69.5	67.3	449963	435802	14161	3.1
46	2015	Jul	69.5	67.3	449992	436011	13981	3.1
46	2015	Aug	69.4	67.3	450016	436266	13750	3.1
46	2015	Sep	69.4	67.3	450107	436606	13501	3
46	2015	Oct	69.3	67.3	450291	437020	13271	2.9
46	2015	Nov	69.3	67.3	450559	437475	13084	2.9
46	2015	Dec	69.3	67.3	450862	437914	12948	2.9
46	2016	Jan	69.3	67.3	451130	438270	12860	2.9
46	2016	Feb	69.3	67.3	451361	438525	12836	2.8
46	2016	Mar	69.3	67.3	451611	438723	12888	2.9
46	2016	Apr	69.3	67.3	451947	438929	13018	2.9
46	2016	May	69.3	67.2	452368	439160	13208	2.9
46	2016	Jun	69.3	67.2	452822	439405	13417	3
46	2016	Jul	69.3	67.2	453237	439630	13607	3
46	2016	Aug	69.3	67.2	453555	439790	13765	3
46	2016	Sep	69.2	67.1	453770	439870	13900	3.1
46	2016	Oct	69.2	67	453880	439859	14021	3.1
46	2016	Nov	69.1	66.9	453963	439833	14130	3.1
46	2016	Dec	69.1	66.9	454122	439900	14222	3.1
46	2017	Jan	69	66.9	454425	440134	14291	3.1
46	2017	Feb	69	66.9	454822	440485	14337	3.2
46	2017	Mar	69	66.9	455220	440838	14382	3.2
46	2017	Apr	69	66.9	455580	441133	14447	3.2
46	2017	May	69	66.8	455900	441358	14542	3.2
46	2017	Jun	69	66.8	456183	441520	14663	3.2
46	2017	Jul	69	66.7	456433	441644	14789	3.2
46	2017	Aug	69	66.7	456677	441802	14875	3.3
46	2017	Sep	68.9	66.7	456949	442057	14892	3.3
46	2017	Oct	68.9	66.7	457283	442454	14829	3.2
46	2017	Nov	68.9	66.7	457627	442897	14730	3.2
46	2017	Dec	68.9	66.7	457922	443288	14634	3.2
46	2018	Jan	69	66.8	458170	443624	14546	3.2
46	2018	Feb	68.9	66.8	458394	443930	14464	3.2
46	2018	Mar	68.9	66.8	458607	444237	14370	3.1
46	2018	Apr	68.9	66.8	458801	444552	14249	3.1
46	2018	May	68.9	66.8	459001	444878	14123	3.1
46	2018	Jun	68.9	66.8	459232	445222	14010	3.1
46	2018	Jul	68.9	66.8	459510	445595	13915	3
46	2018	Aug	68.9	66.8	459843	445991	13852	3
46	2018	Sep	68.9	66.8	460219	446385	13834	3
46	2018	Oct	68.9	66.8	460622	446743	13879	3
46	2018	Nov	68.9	66.8	461020	447039	13981	3
46	2018	Dec	68.9	66.8	461384	447254	14130	3.1
46	2019	Jan	68.9	66.8	461674	447348	14326	3.1
46	2019	Feb	68.9	66.8	461922	447375	14547	3.1
46	2019	Mar	68.9	66.7	462185	447414	14771	3.2
46	2019	Apr	68.9	66.7	462504	447528	14976	3.2
46	2019	May	68.9	66.7	462916	447776	15140	3.3
46	2019	Jun	69	66.7	463467	448192	15275	3.3
46	2019	Jul	69	66.7	464203	448786	15417	3.3
46	2019	Aug	69.1	66.8	464900	449335	15565	3.3
46	2019	Sep	69.1	66.8	465518	449811	15707	3.4
46	2019	Oct	69.1	66.8	465907	450107	15800	3.4
46	2019	Nov	69	66.7	465885	450090	15795	3.4
46	2019	Dec	69	66.7	465805	450033	15772	3.4
46	2020	Jan	69	66.7	466500	450689	15811	3.4
46	2020	Feb	69.1	66.8	467060	451455	15605	3.3
47	2010	Jan	62.4	55.9	3054356	2735355	319001	10.4
47	2010	Feb	62.6	56.2	3066213	2750126	316087	10.3
47	2010	Mar	62.7	56.4	3075346	2764750	310596	10.1
47	2010	Apr	62.7	56.5	3081216	2777976	303240	9.8
47	2010	May	62.7	56.7	3084496	2789401	295095	9.6
47	2010	Jun	62.7	56.8	3086643	2798311	288332	9.3
47	2010	Jul	62.7	56.9	3089678	2804779	284899	9.2
47	2010	Aug	62.7	56.9	3094806	2809696	285110	9.2
47	2010	Sep	62.8	57	3101550	2813356	288194	9.3
47	2010	Oct	62.9	57	3109106	2816726	292380	9.4
47	2010	Nov	63	57	3115946	2820233	295713	9.5
47	2010	Dec	63	57	3120787	2823808	296979	9.5
47	2011	Jan	63.1	57.1	3124117	2827712	296405	9.5
47	2011	Feb	63.1	57.1	3126043	2831472	294571	9.4
47	2011	Mar	63	57.1	3126059	2834304	291755	9.3
47	2011	Apr	63	57.1	3124545	2835688	288857	9.2
47	2011	May	62.9	57.1	3123126	2836330	286796	9.2
47	2011	Jun	62.8	57.1	3122863	2837671	285192	9.1
47	2011	Jul	62.8	57.1	3124288	2841152	283136	9.1
47	2011	Aug	62.8	57.2	3126729	2846814	279915	9
47	2011	Sep	62.8	57.3	3128516	2853571	274945	8.8
47	2011	Oct	62.7	57.3	3128135	2859767	268368	8.6
47	2011	Nov	62.6	57.4	3124159	2863611	260548	8.3
47	2011	Dec	62.4	57.3	3116606	2864164	252442	8.1
47	2012	Jan	62.2	57.3	3107367	2861807	245560	7.9
47	2012	Feb	62	57.1	3099614	2858152	241462	7.8
47	2012	Mar	61.8	57	3095423	2854380	241043	7.8
47	2012	Apr	61.8	56.9	3094396	2851425	242971	7.9
47	2012	May	61.8	56.9	3096056	2850683	245373	7.9
47	2012	Jun	61.8	56.9	3099123	2852564	246559	8
47	2012	Jul	61.8	56.9	3101941	2856431	245510	7.9
47	2012	Aug	61.8	56.9	3104165	2861135	243030	7.8
47	2012	Sep	61.8	57	3106102	2865405	240697	7.7
47	2012	Oct	61.7	57	3106890	2867305	239585	7.7
47	2012	Nov	61.7	56.9	3106236	2865816	240420	7.7
47	2012	Dec	61.6	56.8	3104212	2861299	242913	7.8
47	2013	Jan	61.5	56.6	3100704	2854608	246096	7.9
47	2013	Feb	61.4	56.4	3096126	2847440	248686	8
47	2013	Mar	61.2	56.3	3091218	2841783	249435	8.1
47	2013	Apr	61.1	56.2	3087054	2838906	248148	8
47	2013	May	61	56.1	3082793	2837130	245663	8
47	2013	Jun	60.8	56	3077449	2834469	242980	7.9
47	2013	Jul	60.6	55.9	3070706	2830075	240631	7.8
47	2013	Aug	60.4	55.7	3061555	2824144	237411	7.8
47	2013	Sep	60.1	55.6	3050317	2817923	232394	7.6
47	2013	Oct	59.9	55.4	3039438	2813191	226247	7.4
47	2013	Nov	59.7	55.3	3030812	2811106	219706	7.2
47	2013	Dec	59.5	55.3	3024807	2811443	213364	7.1
47	2014	Jan	59.4	55.4	3022944	2815933	207011	6.8
47	2014	Feb	59.4	55.4	3021307	2818558	202749	6.7
47	2014	Mar	59.3	55.4	3020503	2819891	200612	6.6
47	2014	Apr	59.2	55.3	3019514	2818976	200538	6.6
47	2014	May	59.2	55.2	3018414	2817145	201269	6.7
47	2014	Jun	59.1	55.2	3018281	2816610	201671	6.7
47	2014	Jul	59.1	55.2	3019151	2817933	201218	6.7
47	2014	Aug	59.1	55.2	3021685	2821566	200119	6.6
47	2014	Sep	59.1	55.3	3026100	2827381	198719	6.6
47	2014	Oct	59.2	55.3	3031307	2834731	196576	6.5
47	2014	Nov	59.2	55.5	3036539	2842886	193653	6.4
47	2014	Dec	59.3	55.6	3042288	2851565	190723	6.3
47	2015	Jan	59.3	55.6	3044305	2855925	188380	6.2
47	2015	Feb	59.4	55.7	3050181	2863732	186449	6.1
47	2015	Mar	59.4	55.8	3055134	2870784	184350	6
47	2015	Apr	59.5	55.9	3058341	2876668	181673	5.9
47	2015	May	59.4	56	3059076	2880667	178409	5.8
47	2015	Jun	59.3	55.9	3057336	2882651	174685	5.7
47	2015	Jul	59.2	55.9	3054771	2883967	170804	5.6
47	2015	Aug	59.2	55.9	3053271	2886391	166880	5.5
47	2015	Sep	59.1	56	3054163	2891506	162657	5.3
47	2015	Oct	59.1	56.1	3058683	2900304	158379	5.2
47	2015	Nov	59.2	56.3	3066564	2912026	154538	5
47	2015	Dec	59.4	56.5	3075769	2924671	151098	4.9
47	2016	Jan	59.5	56.6	3084435	2936397	148038	4.8
47	2016	Feb	59.6	56.8	3091802	2946061	145741	4.7
47	2016	Mar	59.7	56.9	3098004	2953586	144418	4.7
47	2016	Apr	59.7	56.9	3104148	2959792	144356	4.7
47	2016	May	59.8	57	3111430	2965923	145507	4.7
47	2016	Jun	59.9	57.1	3120065	2972794	147271	4.7
47	2016	Jul	60.1	57.2	3129351	2980473	148878	4.8
47	2016	Aug	60.2	57.3	3138109	2988032	150077	4.8
47	2016	Sep	60.2	57.3	3145290	2994393	150897	4.8
47	2016	Oct	60.3	57.4	3150157	2999227	150930	4.8
47	2016	Nov	60.3	57.4	3153153	3003560	149593	4.7
47	2016	Dec	60.2	57.4	3155303	3008622	146681	4.6
47	2017	Jan	60.2	57.5	3157342	3014969	142373	4.5
47	2017	Feb	60.2	57.6	3159650	3022805	136845	4.3
47	2017	Mar	60.2	57.7	3162582	3031826	130756	4.1
47	2017	Apr	60.3	57.9	3167000	3042293	124707	3.9
47	2017	May	60.3	58.1	3173238	3054059	119179	3.8
47	2017	Jun	60.4	58.2	3180801	3065895	114906	3.6
47	2017	Jul	60.5	58.4	3189009	3076714	112295	3.5
47	2017	Aug	60.6	58.5	3196661	3085631	111030	3.5
47	2017	Sep	60.7	58.6	3202968	3092243	110725	3.5
47	2017	Oct	60.7	58.6	3207815	3096685	111130	3.5
47	2017	Nov	60.7	58.6	3211390	3099333	112057	3.5
47	2017	Dec	60.7	58.6	3214570	3101384	113186	3.5
47	2018	Jan	60.7	58.6	3218699	3104315	114384	3.6
47	2018	Feb	60.8	58.6	3224656	3109171	115485	3.6
47	2018	Mar	60.9	58.7	3231944	3115677	116267	3.6
47	2018	Apr	61	58.8	3238744	3122149	116595	3.6
47	2018	May	61	58.8	3244194	3127605	116589	3.6
47	2018	Jun	61.1	58.9	3248953	3132762	116191	3.6
47	2018	Jul	61.1	58.9	3253724	3138439	115285	3.5
47	2018	Aug	61.1	59	3259658	3145441	114217	3.5
47	2018	Sep	61.2	59.1	3267423	3154263	113160	3.5
47	2018	Oct	61.4	59.3	3276966	3164697	112269	3.4
47	2018	Nov	61.5	59.4	3287799	3176027	111772	3.4
47	2018	Dec	61.7	59.6	3298883	3187014	111869	3.4
47	2019	Jan	61.8	59.7	3309011	3196491	112520	3.4
47	2019	Feb	61.9	59.8	3317224	3203692	113532	3.4
47	2019	Mar	62	59.8	3323775	3209094	114681	3.5
47	2019	Apr	62	59.9	3329501	3214083	115418	3.5
47	2019	May	62.1	59.9	3334950	3219522	115428	3.5
47	2019	Jun	62.1	60	3340529	3225744	114785	3.4
47	2019	Jul	62.2	60.1	3347516	3233754	113762	3.4
47	2019	Aug	62.3	60.2	3354688	3242107	112581	3.4
47	2019	Sep	62.3	60.3	3361680	3249964	111716	3.3
47	2019	Oct	62.4	60.3	3366977	3255560	111417	3.3
47	2019	Nov	62.3	60.3	3367604	3256017	111587	3.3
47	2019	Dec	62.3	60.2	3366970	3255159	111811	3.3
47	2020	Jan	62.2	60.2	3367254	3255324	111930	3.3
47	2020	Feb	62.2	60	3365911	3251425	114486	3.4
48	2010	Jan	66	60.6	12068751	11067039	1001712	8.3
48	2010	Feb	66.2	60.7	12116512	11112513	1003999	8.3
48	2010	Mar	66.4	60.9	12160592	11157088	1003504	8.3
48	2010	Apr	65.8	60.4	12196433	11196606	999827	8.2
48	2010	May	65.8	60.5	12222758	11230124	992634	8.1
48	2010	Jun	65.8	60.5	12241226	11256000	985226	8
48	2010	Jul	65.8	60.5	12256847	11274789	982058	8
48	2010	Aug	65.8	60.5	12275032	11290591	984441	8
48	2010	Sep	65.8	60.5	12297212	11306452	990760	8.1
48	2010	Oct	65.8	60.5	12323904	11326471	997433	8.1
48	2010	Nov	65.9	60.5	12351634	11350972	1000662	8.1
48	2010	Dec	65.9	60.6	12376187	11377594	998593	8.1
48	2011	Jan	65.9	60.6	12398361	11405419	992942	8
48	2011	Feb	65.9	60.7	12418190	11431874	986316	7.9
48	2011	Mar	65.9	60.7	12434400	11453932	980468	7.9
48	2011	Apr	65.9	60.7	12448436	11470598	977838	7.9
48	2011	May	65.9	60.7	12464746	11484860	979886	7.9
48	2011	Jun	65.9	60.7	12485494	11501815	983679	7.9
48	2011	Jul	65.9	60.7	12510889	11526050	984839	7.9
48	2011	Aug	66	60.8	12538173	11557468	980705	7.8
48	2011	Sep	66	60.9	12562867	11592874	969993	7.7
48	2011	Oct	66	61	12582374	11628674	953700	7.6
48	2011	Nov	65.9	61	12594608	11660707	933901	7.4
48	2011	Dec	65.8	61.1	12599720	11686379	913341	7.2
48	2012	Jan	65.7	61.1	12600830	11705732	895098	7.1
48	2012	Feb	65.7	61.1	12603733	11721887	881846	7
48	2012	Mar	65.6	61	12611236	11736127	875109	6.9
48	2012	Apr	65.6	61	12621391	11749382	872009	6.9
48	2012	May	65.5	61	12634585	11766133	868452	6.9
48	2012	Jun	65.5	61	12651081	11789580	861501	6.8
48	2012	Jul	65.5	61.1	12670049	11820135	849914	6.7
48	2012	Aug	65.5	61.2	12691669	11854807	836862	6.6
48	2012	Sep	65.5	61.3	12715945	11888879	827066	6.5
48	2012	Oct	65.5	61.3	12738355	11915952	822403	6.5
48	2012	Nov	65.5	61.3	12755964	11932919	823045	6.5
48	2012	Dec	65.5	61.2	12768962	11941642	827320	6.5
48	2013	Jan	65.5	61.2	12782095	11950350	831745	6.5
48	2013	Feb	65.4	61.1	12791417	11955951	835466	6.5
48	2013	Mar	65.4	61.1	12804276	11969681	834595	6.5
48	2013	Apr	65.4	61.2	12823913	11994866	829047	6.5
48	2013	May	65.4	61.2	12846262	12024923	821339	6.4
48	2013	Jun	65.4	61.3	12866183	12052275	813908	6.3
48	2013	Jul	65.4	61.3	12881306	12073900	807406	6.3
48	2013	Aug	65.3	61.3	12889379	12090790	798589	6.2
48	2013	Sep	65.2	61.3	12892798	12106935	785863	6.1
48	2013	Oct	65.1	61.2	12899050	12126701	772349	6
48	2013	Nov	65.1	61.3	12912799	12153454	759345	5.9
48	2013	Dec	65.1	61.3	12932783	12186304	746479	5.8
48	2014	Jan	65.1	61.5	12965427	12232666	732761	5.7
48	2014	Feb	65.1	61.5	12985475	12268181	717294	5.5
48	2014	Mar	65.1	61.6	13003115	12299831	703284	5.4
48	2014	Apr	65.1	61.6	13016630	12324725	691905	5.3
48	2014	May	65	61.6	13027345	12345743	681602	5.2
48	2014	Jun	65	61.6	13039482	12367837	671645	5.2
48	2014	Jul	64.9	61.6	13052806	12391017	661789	5.1
48	2014	Aug	64.9	61.6	13066919	12414967	651952	5
48	2014	Sep	64.8	61.6	13079290	12438299	640991	4.9
48	2014	Oct	64.7	61.6	13084576	12457796	626780	4.8
48	2014	Nov	64.6	61.6	13080363	12470156	610207	4.7
48	2014	Dec	64.4	61.5	13071141	12475844	595297	4.6
48	2015	Jan	64.2	61.4	13053525	12469536	583989	4.5
48	2015	Feb	64.1	61.3	13048430	12469746	578684	4.4
48	2015	Mar	64	61.2	13049082	12472470	576612	4.4
48	2015	Apr	63.9	61.1	13054746	12479211	575535	4.4
48	2015	May	63.8	61	13062607	12487773	574834	4.4
48	2015	Jun	63.8	61	13069936	12495242	574694	4.4
48	2015	Jul	63.7	60.9	13078000	12501778	576222	4.4
48	2015	Aug	63.6	60.8	13088345	12508795	579550	4.4
48	2015	Sep	63.6	60.8	13101981	12519355	582626	4.4
48	2015	Oct	63.6	60.8	13122196	12537645	584551	4.5
48	2015	Nov	63.6	60.8	13149639	12564036	585603	4.5
48	2015	Dec	63.7	60.8	13179976	12594665	585311	4.4
48	2016	Jan	63.7	60.9	13208828	12624562	584266	4.4
48	2016	Feb	63.7	60.9	13234764	12649925	584839	4.4
48	2016	Mar	63.7	60.9	13257970	12669432	588538	4.4
48	2016	Apr	63.8	60.9	13280901	12684335	596566	4.5
48	2016	May	63.8	60.9	13305802	12697623	608179	4.6
48	2016	Jun	63.8	60.8	13331528	12711478	620050	4.7
48	2016	Jul	63.8	60.8	13356210	12726964	629246	4.7
48	2016	Aug	63.8	60.8	13378885	12743432	635453	4.7
48	2016	Sep	63.8	60.8	13399340	12759137	640203	4.8
48	2016	Oct	63.8	60.8	13416647	12773301	643346	4.8
48	2016	Nov	63.8	60.7	13432470	12788698	643772	4.8
48	2016	Dec	63.8	60.8	13449886	12808057	641829	4.8
48	2017	Jan	63.8	60.8	13469939	12832003	637936	4.7
48	2017	Feb	63.8	60.8	13490852	12860135	630717	4.7
48	2017	Mar	63.8	60.9	13509998	12889646	620352	4.6
48	2017	Apr	63.8	61	13527910	12919986	607924	4.5
48	2017	May	63.8	61	13545404	12951366	594038	4.4
48	2017	Jun	63.8	61.1	13563216	12982307	580909	4.3
48	2017	Jul	63.8	61.2	13582350	13011793	570557	4.2
48	2017	Aug	63.8	61.2	13601714	13038893	562821	4.1
48	2017	Sep	63.8	61.2	13621164	13063996	557168	4.1
48	2017	Oct	63.9	61.3	13641289	13087950	553339	4.1
48	2017	Nov	63.9	61.3	13661966	13110303	551663	4
48	2017	Dec	63.9	61.3	13683655	13132506	551149	4
48	2018	Jan	63.9	61.4	13707892	13156374	551518	4
48	2018	Feb	64	61.4	13735386	13182948	552438	4
48	2018	Mar	64	61.5	13762997	13211042	551955	4
48	2018	Apr	64.1	61.5	13784494	13236243	548251	4
48	2018	May	64	61.5	13798149	13256169	541980	3.9
48	2018	Jun	64	61.5	13807325	13273403	533922	3.9
48	2018	Jul	64	61.5	13815834	13290921	524913	3.8
48	2018	Aug	63.9	61.5	13829344	13311213	518131	3.7
48	2018	Sep	63.9	61.6	13850222	13334935	515287	3.7
48	2018	Oct	64	61.6	13876594	13360885	515709	3.7
48	2018	Nov	64	61.6	13903768	13386988	516780	3.7
48	2018	Dec	64	61.7	13925197	13409628	515569	3.7
48	2019	Jan	64	61.7	13936827	13426550	510277	3.7
48	2019	Feb	63.9	61.6	13939304	13437974	501330	3.6
48	2019	Mar	63.9	61.6	13939677	13447760	491917	3.5
48	2019	Apr	63.8	61.6	13946357	13461899	484458	3.5
48	2019	May	63.8	61.6	13964638	13483946	480692	3.4
48	2019	Jun	63.9	61.7	13996248	13514401	481847	3.4
48	2019	Jul	64	61.8	14042579	13555554	487025	3.5
48	2019	Aug	64.1	61.9	14090993	13598543	492450	3.5
48	2019	Sep	64.2	62	14133202	13637428	495774	3.5
48	2019	Oct	64.2	62	14160862	13663754	497108	3.5
48	2019	Nov	64.2	61.9	14161219	13664882	496337	3.5
48	2019	Dec	64.1	61.8	14155916	13660124	495792	3.5
48	2020	Jan	64.1	61.9	14180789	13686397	494392	3.5
48	2020	Feb	64.1	61.9	14200106	13707631	492475	3.5
49	2010	Jan	68	62.7	1355042	1247979	107063	7.9
49	2010	Feb	68	62.6	1355856	1248210	107646	7.9
49	2010	Mar	67.9	62.5	1356837	1248856	107981	8
49	2010	Apr	69.6	64	1357702	1249619	108083	8
49	2010	May	69.5	64	1358240	1250301	107939	7.9
49	2010	Jun	69.4	63.9	1358279	1250702	107577	7.9
49	2010	Jul	69.3	63.8	1357782	1250758	107024	7.9
49	2010	Aug	69.1	63.7	1356853	1250576	106277	7.8
49	2010	Sep	69	63.6	1355732	1250305	105427	7.8
49	2010	Oct	68.8	63.5	1354775	1250248	104527	7.7
49	2010	Nov	68.7	63.4	1354026	1250532	103494	7.6
49	2010	Dec	68.6	63.4	1353411	1251055	102356	7.6
49	2011	Jan	68.4	63.3	1352758	1251698	101060	7.5
49	2011	Feb	68.3	63.3	1351854	1252350	99504	7.4
49	2011	Mar	68.2	63.2	1350661	1252983	97678	7.2
49	2011	Apr	68	63.2	1349388	1253673	95715	7.1
49	2011	May	67.9	63.1	1348372	1254595	93777	7
49	2011	Jun	67.8	63.1	1347853	1255940	91913	6.8
49	2011	Jul	67.7	63.1	1347981	1257868	90113	6.7
49	2011	Aug	67.6	63.2	1348691	1260385	88306	6.5
49	2011	Sep	67.6	63.2	1349818	1263369	86449	6.4
49	2011	Oct	67.5	63.3	1351199	1266619	84580	6.3
49	2011	Nov	67.5	63.4	1352773	1269973	82800	6.1
49	2011	Dec	67.5	63.5	1354655	1273494	81161	6
49	2012	Jan	67.5	63.6	1357156	1277412	79744	5.9
49	2012	Feb	67.6	63.7	1360331	1281733	78598	5.8
49	2012	Mar	67.7	63.8	1363728	1286115	77613	5.7
49	2012	Apr	67.7	64	1366813	1290232	76581	5.6
49	2012	May	67.8	64.1	1369443	1293997	75446	5.5
49	2012	Jun	67.8	64.1	1371758	1297527	74231	5.4
49	2012	Jul	67.8	64.2	1373996	1300979	73017	5.3
49	2012	Aug	67.8	64.3	1376447	1304435	72012	5.2
49	2012	Sep	67.8	64.3	1379310	1307993	71317	5.2
49	2012	Oct	67.9	64.4	1382469	1311679	70790	5.1
49	2012	Nov	67.9	64.5	1385729	1315424	70305	5.1
49	2012	Dec	68	64.6	1388824	1319092	69732	5
49	2013	Jan	68	64.7	1391627	1322501	69126	5
49	2013	Feb	68.1	64.7	1394091	1325786	68305	4.9
49	2013	Mar	68.1	64.8	1396655	1329253	67402	4.8
49	2013	Apr	68.1	64.9	1399488	1332981	66507	4.8
49	2013	May	68.2	65	1402385	1336692	65693	4.7
49	2013	Jun	68.2	65	1405140	1340161	64979	4.6
49	2013	Jul	68.2	65.1	1407731	1343422	64309	4.6
49	2013	Aug	68.2	65.1	1410108	1346638	63470	4.5
49	2013	Sep	68.2	65.2	1412304	1349876	62428	4.4
49	2013	Oct	68.2	65.3	1414439	1353091	61348	4.3
49	2013	Nov	68.2	65.3	1416452	1356215	60237	4.3
49	2013	Dec	68.2	65.4	1418146	1359114	59032	4.2
49	2014	Jan	68.2	65.4	1419160	1361596	57564	4.1
49	2014	Feb	68.1	65.4	1419938	1363612	56326	4
49	2014	Mar	68.1	65.4	1420471	1365208	55263	3.9
49	2014	Apr	68	65.4	1421071	1366570	54501	3.8
49	2014	May	67.9	65.4	1422094	1368063	54031	3.8
49	2014	Jun	67.9	65.4	1423798	1369960	53838	3.8
49	2014	Jul	67.9	65.4	1426066	1372207	53859	3.8
49	2014	Aug	68	65.4	1428747	1374813	53934	3.8
49	2014	Sep	68	65.4	1431682	1377823	53859	3.8
49	2014	Oct	68	65.5	1434712	1381195	53517	3.7
49	2014	Nov	68	65.5	1437708	1384724	52984	3.7
49	2014	Dec	68.1	65.6	1440711	1388215	52496	3.6
49	2015	Jan	68.1	65.6	1443389	1391016	52373	3.6
49	2015	Feb	68.1	65.7	1446487	1394143	52344	3.6
49	2015	Mar	68.2	65.7	1449729	1397198	52531	3.6
49	2015	Apr	68.2	65.8	1453015	1400188	52827	3.6
49	2015	May	68.3	65.8	1456167	1403065	53102	3.6
49	2015	Jun	68.3	65.8	1459024	1405780	53244	3.6
49	2015	Jul	68.3	65.8	1461671	1408428	53243	3.6
49	2015	Aug	68.3	65.8	1464257	1411098	53159	3.6
49	2015	Sep	68.3	65.8	1466908	1413861	53047	3.6
49	2015	Oct	68.2	65.8	1469870	1416885	52985	3.6
49	2015	Nov	68.3	65.8	1473367	1420301	53066	3.6
49	2015	Dec	68.3	65.9	1477364	1424113	53251	3.6
49	2016	Jan	68.4	65.9	1481650	1428215	53435	3.6
49	2016	Feb	68.4	66	1486078	1432542	53536	3.6
49	2016	Mar	68.5	66	1490527	1437096	53431	3.6
49	2016	Apr	68.6	66.1	1494995	1441914	53081	3.6
49	2016	May	68.6	66.2	1499573	1447004	52569	3.5
49	2016	Jun	68.7	66.3	1504205	1452230	51975	3.5
49	2016	Jul	68.8	66.4	1508689	1457308	51381	3.4
49	2016	Aug	68.8	66.5	1512882	1461959	50923	3.4
49	2016	Sep	68.8	66.5	1516761	1466066	50695	3.3
49	2016	Oct	68.8	66.5	1520334	1469678	50656	3.3
49	2016	Nov	68.9	66.6	1523755	1473056	50699	3.3
49	2016	Dec	68.9	66.6	1527197	1476432	50765	3.3
49	2017	Jan	68.9	66.6	1530749	1479893	50856	3.3
49	2017	Feb	68.9	66.6	1534344	1483394	50950	3.3
49	2017	Mar	68.9	66.6	1537790	1486736	51054	3.3
49	2017	Apr	68.9	66.7	1540998	1489857	51141	3.3
49	2017	May	68.9	66.7	1543901	1492770	51131	3.3
49	2017	Jun	68.9	66.6	1546548	1495521	51027	3.3
49	2017	Jul	68.9	66.6	1549122	1498261	50861	3.3
49	2017	Aug	68.9	66.6	1551585	1500992	50593	3.3
49	2017	Sep	68.8	66.6	1553867	1503651	50216	3.2
49	2017	Oct	68.8	66.6	1555978	1506213	49765	3.2
49	2017	Nov	68.7	66.6	1557840	1508523	49317	3.2
49	2017	Dec	68.7	66.5	1559444	1510541	48903	3.1
49	2018	Jan	68.6	66.5	1560861	1512307	48554	3.1
49	2018	Feb	68.6	66.4	1562204	1513912	48292	3.1
49	2018	Mar	68.5	66.4	1563548	1515420	48128	3.1
49	2018	Apr	68.4	66.3	1564856	1516798	48058	3.1
49	2018	May	68.4	66.3	1566153	1518105	48048	3.1
49	2018	Jun	68.3	66.2	1567598	1519575	48023	3.1
49	2018	Jul	68.2	66.2	1569298	1521391	47907	3.1
49	2018	Aug	68.2	66.1	1571430	1523699	47731	3
49	2018	Sep	68.2	66.1	1574010	1526507	47503	3
49	2018	Oct	68.2	66.1	1576846	1529637	47209	3
49	2018	Nov	68.2	66.1	1579845	1533017	46828	3
49	2018	Dec	68.2	66.2	1583000	1536644	46356	2.9
49	2019	Jan	68.2	66.2	1586291	1540489	45802	2.9
49	2019	Feb	68.2	66.3	1589639	1544481	45158	2.8
49	2019	Mar	68.2	66.3	1593090	1548643	44447	2.8
49	2019	Apr	68.3	66.4	1596715	1553061	43654	2.7
49	2019	May	68.3	66.5	1600547	1557758	42789	2.7
49	2019	Jun	68.3	66.5	1604610	1562707	41903	2.6
49	2019	Jul	68.4	66.7	1609459	1568424	41035	2.5
49	2019	Aug	68.5	66.8	1614356	1574085	40271	2.5
49	2019	Sep	68.5	66.8	1618990	1579270	39720	2.5
49	2019	Oct	68.5	66.9	1622472	1583040	39432	2.4
49	2019	Nov	68.4	66.8	1622909	1583400	39509	2.4
49	2019	Dec	68.3	66.6	1622443	1582820	39623	2.4
49	2020	Jan	68.3	66.7	1626802	1586763	40039	2.5
49	2020	Feb	68.4	66.7	1630696	1590242	40454	2.5
50	2010	Jan	70.5	66.1	358889	336293	22596	6.3
50	2010	Feb	70.6	66.1	359206	336679	22527	6.3
50	2010	Mar	70.6	66.2	359488	337067	22421	6.2
50	2010	Apr	71	66.6	359650	337367	22283	6.2
50	2010	May	71	66.6	359676	337561	22115	6.1
50	2010	Jun	71	66.6	359582	337664	21918	6.1
50	2010	Jul	70.9	66.6	359413	337695	21718	6
50	2010	Aug	70.8	66.6	359276	337710	21566	6
50	2010	Sep	70.8	66.5	359252	337779	21473	6
50	2010	Oct	70.7	66.5	359347	337959	21388	6
50	2010	Nov	70.7	66.5	359482	338211	21271	5.9
50	2010	Dec	70.7	66.5	359583	338459	21124	5.9
50	2011	Jan	70.7	66.5	359600	338684	20916	5.8
50	2011	Feb	70.6	66.6	359462	338839	20623	5.7
50	2011	Mar	70.5	66.5	359114	338856	20258	5.6
50	2011	Apr	70.4	66.5	358632	338757	19875	5.5
50	2011	May	70.2	66.4	358156	338583	19573	5.5
50	2011	Jun	70.1	66.3	357806	338394	19412	5.4
50	2011	Jul	70	66.3	357628	338273	19355	5.4
50	2011	Aug	70	66.2	357560	338229	19331	5.4
50	2011	Sep	70	66.2	357501	338220	19281	5.4
50	2011	Oct	70	66.2	357373	338215	19158	5.4
50	2011	Nov	69.9	66.2	357092	338179	18913	5.3
50	2011	Dec	69.8	66.2	356626	338085	18541	5.2
50	2012	Jan	69.7	66.1	356060	337924	18136	5.1
50	2012	Feb	69.6	66.1	355564	337735	17829	5
50	2012	Mar	69.5	66.1	355263	337573	17690	5
50	2012	Apr	69.5	66	355193	337472	17721	5
50	2012	May	69.5	66	355266	337429	17837	5
50	2012	Jun	69.5	66	355347	337423	17924	5
50	2012	Jul	69.5	66	355337	337423	17914	5
50	2012	Aug	69.5	66	355150	337388	17762	5
50	2012	Sep	69.4	65.9	354731	337260	17471	4.9
50	2012	Oct	69.2	65.9	354098	337000	17098	4.8
50	2012	Nov	69	65.8	353371	336655	16716	4.7
50	2012	Dec	68.9	65.7	352681	336295	16386	4.6
50	2013	Jan	68.8	65.6	352098	335962	16136	4.6
50	2013	Feb	68.7	65.6	351601	335640	15961	4.5
50	2013	Mar	68.6	65.5	351208	335359	15849	4.5
50	2013	Apr	68.5	65.4	350902	335131	15771	4.5
50	2013	May	68.5	65.4	350653	334953	15700	4.5
50	2013	Jun	68.4	65.3	350450	334828	15622	4.5
50	2013	Jul	68.3	65.3	350269	334747	15522	4.4
50	2013	Aug	68.3	65.3	350093	334713	15380	4.4
50	2013	Sep	68.2	65.3	349922	334732	15190	4.3
50	2013	Oct	68.2	65.3	349740	334774	14966	4.3
50	2013	Nov	68.1	65.3	349505	334766	14739	4.2
50	2013	Dec	68.1	65.3	349195	334664	14531	4.2
50	2014	Jan	68	65.2	348789	334392	14397	4.1
50	2014	Feb	67.9	65.1	348373	334148	14225	4.1
50	2014	Mar	67.9	65.1	347991	333927	14064	4
50	2014	Apr	67.8	65.1	347648	333732	13916	4
50	2014	May	67.7	65	347340	333562	13778	4
50	2014	Jun	67.6	65	347058	333408	13650	3.9
50	2014	Jul	67.6	64.9	346782	333246	13536	3.9
50	2014	Aug	67.5	64.9	346532	333089	13443	3.9
50	2014	Sep	67.5	64.8	346335	332962	13373	3.9
50	2014	Oct	67.4	64.8	346193	332882	13311	3.8
50	2014	Nov	67.4	64.8	346103	332866	13237	3.8
50	2014	Dec	67.3	64.8	346056	332922	13134	3.8
50	2015	Jan	67.4	64.8	346140	333128	13012	3.8
50	2015	Feb	67.3	64.8	346065	333208	12857	3.7
50	2015	Mar	67.3	64.8	345916	333220	12696	3.7
50	2015	Apr	67.2	64.8	345658	333115	12543	3.6
50	2015	May	67.2	64.7	345293	332883	12410	3.6
50	2015	Jun	67	64.7	344857	332558	12299	3.6
50	2015	Jul	66.9	64.6	344407	332209	12198	3.5
50	2015	Aug	66.9	64.5	343988	331896	12092	3.5
50	2015	Sep	66.8	64.5	343654	331684	11970	3.5
50	2015	Oct	66.7	64.4	343472	331636	11836	3.4
50	2015	Nov	66.7	64.5	343457	331759	11698	3.4
50	2015	Dec	66.8	64.5	343581	332010	11571	3.4
50	2016	Jan	66.8	64.6	343783	332316	11467	3.3
50	2016	Feb	66.9	64.6	344012	332618	11394	3.3
50	2016	Mar	66.9	64.7	344235	332889	11346	3.3
50	2016	Apr	66.9	64.7	344432	333124	11308	3.3
50	2016	May	67	64.8	344602	333340	11262	3.3
50	2016	Jun	67	64.8	344754	333559	11195	3.2
50	2016	Jul	67	64.9	344897	333788	11109	3.2
50	2016	Aug	67	64.9	345054	334040	11014	3.2
50	2016	Sep	67	64.9	345211	334287	10924	3.2
50	2016	Oct	67	64.9	345320	334465	10855	3.1
50	2016	Nov	67	64.9	345362	334551	10811	3.1
50	2016	Dec	67	64.9	345332	334549	10783	3.1
50	2017	Jan	67	64.9	345256	334506	10750	3.1
50	2017	Feb	67	64.9	345177	334487	10690	3.1
50	2017	Mar	66.9	64.9	345141	334542	10599	3.1
50	2017	Apr	66.9	64.9	345195	334713	10482	3
50	2017	May	66.9	64.9	345346	334993	10353	3
50	2017	Jun	67	65	345563	335338	10225	3
50	2017	Jul	67	65	345823	335717	10106	2.9
50	2017	Aug	67	65.1	346055	336064	9991	2.9
50	2017	Sep	67	65.1	346211	336340	9871	2.9
50	2017	Oct	67	65.2	346301	336560	9741	2.8
50	2017	Nov	67	65.2	346324	336722	9602	2.8
50	2017	Dec	67	65.2	346302	336833	9469	2.7
50	2018	Jan	67	65.2	346242	336887	9355	2.7
50	2018	Feb	67	65.2	346156	336893	9263	2.7
50	2018	Mar	67	65.2	346063	336880	9183	2.7
50	2018	Apr	66.9	65.2	345950	336849	9101	2.6
50	2018	May	66.9	65.2	345804	336798	9006	2.6
50	2018	Jun	66.8	65.1	345614	336722	8892	2.6
50	2018	Jul	66.8	65.1	345363	336600	8763	2.5
50	2018	Aug	66.7	65	345074	336441	8633	2.5
50	2018	Sep	66.6	65	344789	336276	8513	2.5
50	2018	Oct	66.6	64.9	344533	336125	8408	2.4
50	2018	Nov	66.5	64.9	344339	336025	8314	2.4
50	2018	Dec	66.5	64.9	344212	335986	8226	2.4
50	2019	Jan	66.5	64.9	344128	335981	8147	2.4
50	2019	Feb	66.4	64.9	344021	335938	8083	2.3
50	2019	Mar	66.4	64.8	343817	335772	8045	2.3
50	2019	Apr	66.3	64.8	343481	335445	8036	2.3
50	2019	May	66.2	64.7	343025	334970	8055	2.3
50	2019	Jun	66.1	64.5	342493	334399	8094	2.4
50	2019	Jul	66	64.4	341929	333781	8148	2.4
50	2019	Aug	65.8	64.3	341361	333162	8199	2.4
50	2019	Sep	65.8	64.2	340947	332709	8238	2.4
50	2019	Oct	65.7	64.1	340685	332422	8263	2.4
50	2019	Nov	65.7	64.1	340681	332418	8263	2.4
50	2019	Dec	65.7	64.1	340749	332491	8258	2.4
50	2020	Jan	65.6	64	340538	332233	8305	2.4
50	2020	Feb	65.6	64	340147	331952	8195	2.4
51	2010	Jan	68	63	4111141	3805371	305770	7.4
51	2010	Feb	68.2	63.1	4124601	3817085	307516	7.5
51	2010	Mar	68.3	63.3	4137711	3830874	306837	7.4
51	2010	Apr	67.5	62.5	4148999	3844786	304213	7.3
51	2010	May	67.6	62.7	4157743	3857567	300176	7.2
51	2010	Jun	67.6	62.8	4163295	3867279	296016	7.1
51	2010	Jul	67.5	62.8	4166373	3873305	293068	7
51	2010	Aug	67.5	62.8	4168725	3877131	291594	7
51	2010	Sep	67.5	62.8	4171404	3880460	290944	7
51	2010	Oct	67.5	62.8	4175430	3885597	289833	6.9
51	2010	Nov	67.5	62.8	4180277	3892824	287453	6.9
51	2010	Dec	67.5	62.9	4184771	3900973	283798	6.8
51	2011	Jan	67.5	63	4188985	3909237	279748	6.7
51	2011	Feb	67.5	63	4192419	3916211	276208	6.6
51	2011	Mar	67.4	63	4194471	3920687	273784	6.5
51	2011	Apr	67.4	63	4195672	3922364	273308	6.5
51	2011	May	67.4	63	4197759	3922591	275168	6.6
51	2011	Jun	67.4	62.9	4202228	3923950	278278	6.6
51	2011	Jul	67.4	62.9	4209618	3928498	281120	6.7
51	2011	Aug	67.5	63	4218678	3936029	282649	6.7
51	2011	Sep	67.5	63	4227345	3945096	282249	6.7
51	2011	Oct	67.6	63.1	4233999	3954022	279977	6.6
51	2011	Nov	67.5	63.1	4236996	3960885	276111	6.5
51	2011	Dec	67.5	63.1	4235857	3964606	271251	6.4
51	2012	Jan	67.3	63.1	4231959	3965563	266396	6.3
51	2012	Feb	67.2	63	4227576	3964867	262709	6.2
51	2012	Mar	67.1	62.9	4223386	3962491	260895	6.2
51	2012	Apr	66.9	62.8	4219059	3958783	260276	6.2
51	2012	May	66.8	62.7	4215862	3955951	259911	6.2
51	2012	Jun	66.7	62.6	4214807	3955826	258981	6.1
51	2012	Jul	66.7	62.6	4216026	3959188	256838	6.1
51	2012	Aug	66.7	62.7	4219676	3965800	253876	6
51	2012	Sep	66.7	62.8	4225316	3974214	251102	5.9
51	2012	Oct	66.7	62.8	4230738	3981872	248866	5.9
51	2012	Nov	66.7	62.8	4234388	3986946	247442	5.8
51	2012	Dec	66.7	62.8	4235476	3988734	246742	5.8
51	2013	Jan	66.6	62.7	4233882	3987394	246488	5.8
51	2013	Feb	66.5	62.7	4231342	3985091	246251	5.8
51	2013	Mar	66.5	62.6	4230364	3984797	245567	5.8
51	2013	Apr	66.5	62.6	4232476	3988103	244373	5.8
51	2013	May	66.5	62.7	4236360	3993156	243204	5.7
51	2013	Jun	66.5	62.7	4240390	3997692	242698	5.7
51	2013	Jul	66.5	62.7	4243329	4000637	242692	5.7
51	2013	Aug	66.4	62.6	4243935	4001894	242041	5.7
51	2013	Sep	66.4	62.6	4242422	4002314	240108	5.7
51	2013	Oct	66.3	62.6	4240822	4003108	237714	5.6
51	2013	Nov	66.2	62.6	4240890	4005444	235446	5.6
51	2013	Dec	66.2	62.6	4242889	4009409	233480	5.5
51	2014	Jan	66.2	62.6	4243063	4011746	231317	5.5
51	2014	Feb	66.2	62.6	4246185	4016655	229530	5.4
51	2014	Mar	66.2	62.6	4248247	4020018	228229	5.4
51	2014	Apr	66.1	62.6	4248198	4020708	227490	5.4
51	2014	May	66	62.5	4246223	4019716	226507	5.3
51	2014	Jun	66	62.5	4243692	4018945	224747	5.3
51	2014	Jul	65.9	62.4	4241063	4018636	222427	5.2
51	2014	Aug	65.8	62.4	4239070	4019184	219886	5.2
51	2014	Sep	65.7	62.3	4237867	4020659	217208	5.1
51	2014	Oct	65.6	62.3	4236442	4022274	214168	5.1
51	2014	Nov	65.5	62.3	4233898	4023082	210816	5
51	2014	Dec	65.5	62.2	4231098	4023247	207851	4.9
51	2015	Jan	65.4	62.2	4228612	4023313	205299	4.9
51	2015	Feb	65.3	62.2	4226909	4023365	203544	4.8
51	2015	Mar	65.3	62.1	4225814	4024415	201399	4.8
51	2015	Apr	65.2	62.1	4224748	4026561	198187	4.7
51	2015	May	65.1	62.1	4222632	4028709	193923	4.6
51	2015	Jun	65	62.1	4218688	4029725	188963	4.5
51	2015	Jul	64.9	62.1	4213773	4029769	184004	4.4
51	2015	Aug	64.8	62	4209037	4029329	179708	4.3
51	2015	Sep	64.7	62	4205561	4029258	176303	4.2
51	2015	Oct	64.6	62	4205086	4031145	173941	4.1
51	2015	Nov	64.6	62	4208081	4035413	172668	4.1
51	2015	Dec	64.7	62	4212798	4040905	171893	4.1
51	2016	Jan	64.7	62.1	4217419	4046321	171098	4.1
51	2016	Feb	64.7	62.1	4221083	4050676	170407	4
51	2016	Mar	64.7	62.1	4223683	4053627	170056	4
51	2016	Apr	64.8	62.1	4226269	4055795	170474	4
51	2016	May	64.8	62.1	4230261	4058438	171823	4.1
51	2016	Jun	64.8	62.2	4236047	4062274	173773	4.1
51	2016	Jul	64.9	62.2	4243217	4067551	175666	4.1
51	2016	Aug	65	62.3	4251076	4073950	177126	4.2
51	2016	Sep	65	62.3	4258801	4080800	178001	4.2
51	2016	Oct	65.1	62.4	4265400	4087526	177874	4.2
51	2016	Nov	65.1	62.4	4271133	4094578	176555	4.1
51	2016	Dec	65.1	62.5	4276971	4102515	174456	4.1
51	2017	Jan	65.2	62.6	4283427	4111349	172078	4
51	2017	Feb	65.3	62.7	4290337	4120793	169544	4
51	2017	Mar	65.3	62.8	4296893	4129781	167112	3.9
51	2017	Apr	65.4	62.9	4303237	4138362	164875	3.8
51	2017	May	65.4	63	4309486	4146856	162630	3.8
51	2017	Jun	65.5	63	4315181	4154719	160462	3.7
51	2017	Jul	65.5	63.1	4319979	4161450	158529	3.7
51	2017	Aug	65.5	63.1	4323055	4166527	156528	3.6
51	2017	Sep	65.5	63.1	4324186	4170033	154153	3.6
51	2017	Oct	65.4	63.1	4323829	4172499	151330	3.5
51	2017	Nov	65.4	63.1	4322440	4174224	148216	3.4
51	2017	Dec	65.3	63.1	4321090	4176250	144840	3.4
51	2018	Jan	65.3	63.2	4321285	4179688	141597	3.3
51	2018	Feb	65.3	63.2	4324074	4185221	138853	3.2
51	2018	Mar	65.4	63.3	4328875	4192335	136540	3.2
51	2018	Apr	65.4	63.4	4333258	4198820	134438	3.1
51	2018	May	65.4	63.4	4335747	4203196	132551	3.1
51	2018	Jun	65.4	63.4	4336930	4206240	130690	3
51	2018	Jul	65.4	63.4	4337899	4209196	128703	3
51	2018	Aug	65.4	63.5	4340536	4213317	127219	2.9
51	2018	Sep	65.4	63.5	4345973	4219278	126695	2.9
51	2018	Oct	65.5	63.6	4354026	4226855	127171	2.9
51	2018	Nov	65.6	63.7	4363519	4235273	128246	2.9
51	2018	Dec	65.7	63.8	4372388	4243038	129350	3
51	2019	Jan	65.8	63.8	4378779	4248896	129883	3
51	2019	Feb	65.8	63.9	4381973	4252554	129419	3
51	2019	Mar	65.8	63.9	4383549	4255394	128155	2.9
51	2019	Apr	65.8	63.9	4385945	4259615	126330	2.9
51	2019	May	65.9	64	4390760	4266437	124323	2.8
51	2019	Jun	66	64.1	4398723	4276136	122587	2.8
51	2019	Jul	66.1	64.3	4410824	4289574	121250	2.7
51	2019	Aug	66.3	64.5	4423894	4303811	120083	2.7
51	2019	Sep	66.4	64.6	4435867	4316769	119098	2.7
51	2019	Oct	66.5	64.7	4444122	4325663	118459	2.7
51	2019	Nov	66.5	64.7	4444649	4326215	118434	2.7
51	2019	Dec	66.4	64.6	4443312	4324694	118618	2.7
51	2020	Jan	66.5	64.8	4453928	4335613	118315	2.7
51	2020	Feb	66.6	64.9	4462717	4345451	117266	2.6
53	2010	Jan	67.7	60.6	3530511	3163087	367424	10.4
53	2010	Feb	67.6	60.6	3529820	3163688	366132	10.4
53	2010	Mar	67.5	60.5	3528642	3165760	362882	10.3
53	2010	Apr	67.4	60.5	3526005	3167824	358181	10.2
53	2010	May	67.2	60.5	3521607	3168900	352707	10
53	2010	Jun	67.1	60.4	3516112	3168197	347915	9.9
53	2010	Jul	66.9	60.3	3510442	3165672	344770	9.8
53	2010	Aug	66.7	60.2	3505035	3161962	343073	9.8
53	2010	Sep	66.6	60	3499873	3157493	342380	9.8
53	2010	Oct	66.4	59.9	3494542	3152803	341739	9.8
53	2010	Nov	66.2	59.7	3488162	3148027	340135	9.8
53	2010	Dec	66	59.6	3480699	3143385	337314	9.7
53	2011	Jan	65.8	59.4	3473305	3139432	333873	9.6
53	2011	Feb	65.6	59.3	3466972	3136312	330660	9.5
53	2011	Mar	65.4	59.2	3462169	3134099	328070	9.5
53	2011	Apr	65.3	59.2	3458969	3132796	326173	9.4
53	2011	May	65.2	59.1	3457455	3132444	325011	9.4
53	2011	Jun	65.2	59	3457160	3133149	324011	9.4
53	2011	Jul	65.1	59	3457441	3134999	322442	9.3
53	2011	Aug	65	59	3458076	3138052	320024	9.3
53	2011	Sep	65	59	3459142	3142610	316532	9.2
53	2011	Oct	64.9	59.1	3461153	3148737	312416	9
53	2011	Nov	64.9	59.1	3464012	3155902	308110	8.9
53	2011	Dec	64.9	59.2	3467287	3163381	303906	8.8
53	2012	Jan	64.9	59.3	3470587	3170602	299985	8.6
53	2012	Feb	64.9	59.3	3473802	3177049	296753	8.5
53	2012	Mar	64.9	59.4	3476293	3181677	294616	8.5
53	2012	Apr	64.8	59.3	3477069	3183933	293136	8.4
53	2012	May	64.7	59.3	3476271	3184854	291417	8.4
53	2012	Jun	64.6	59.2	3474422	3185871	288551	8.3
53	2012	Jul	64.5	59.2	3472005	3188024	283981	8.2
53	2012	Aug	64.4	59.2	3469717	3191534	278183	8
53	2012	Sep	64.3	59.3	3468162	3196070	272092	7.8
53	2012	Oct	64.2	59.3	3466906	3200714	266192	7.7
53	2012	Nov	64.1	59.3	3465690	3204626	261064	7.5
53	2012	Dec	64.1	59.3	3464263	3207318	256945	7.4
53	2013	Jan	64	59.3	3465517	3208679	256838	7.4
53	2013	Feb	63.9	59.3	3463646	3209467	254179	7.3
53	2013	Mar	63.9	59.2	3462290	3210734	251556	7.3
53	2013	Apr	63.8	59.2	3462153	3213298	248855	7.2
53	2013	May	63.8	59.2	3462821	3216430	246391	7.1
53	2013	Jun	63.7	59.2	3463764	3219285	244479	7.1
53	2013	Jul	63.7	59.2	3464802	3221747	243055	7
53	2013	Aug	63.6	59.2	3465091	3223955	241136	7
53	2013	Sep	63.5	59.2	3464302	3226128	238174	6.9
53	2013	Oct	63.4	59.1	3463476	3228657	234819	6.8
53	2013	Nov	63.3	59.1	3463397	3231944	231453	6.7
53	2013	Dec	63.3	59.1	3464000	3235814	228186	6.6
53	2014	Jan	63.2	59.1	3466069	3241018	225051	6.5
53	2014	Feb	63.2	59.1	3467365	3245636	221729	6.4
53	2014	Mar	63.1	59.2	3469314	3250620	218694	6.3
53	2014	Apr	63.1	59.2	3472139	3255934	216205	6.2
53	2014	May	63.1	59.2	3476356	3262188	214168	6.2
53	2014	Jun	63.2	59.3	3482697	3270052	212645	6.1
53	2014	Jul	63.2	59.4	3490819	3279108	211711	6.1
53	2014	Aug	63.3	59.5	3500118	3288804	211314	6
53	2014	Sep	63.4	59.5	3509426	3298343	211083	6
53	2014	Oct	63.4	59.6	3516923	3306734	210189	6
53	2014	Nov	63.4	59.6	3521640	3313329	208311	5.9
53	2014	Dec	63.3	59.6	3524615	3318563	206052	5.8
53	2015	Jan	63.3	59.7	3527423	3323927	203496	5.8
53	2015	Feb	63.3	59.7	3530769	3328459	202310	5.7
53	2015	Mar	63.3	59.7	3534762	3333200	201562	5.7
53	2015	Apr	63.3	59.7	3539214	3338296	200918	5.7
53	2015	May	63.3	59.7	3543453	3343245	200208	5.7
53	2015	Jun	63.2	59.7	3546806	3347419	199387	5.6
53	2015	Jul	63.2	59.6	3549667	3350958	198709	5.6
53	2015	Aug	63.1	59.6	3552953	3354575	198378	5.6
53	2015	Sep	63.1	59.6	3557770	3359519	198251	5.6
53	2015	Oct	63.1	59.6	3565501	3367152	198349	5.6
53	2015	Nov	63.2	59.7	3576422	3377702	198720	5.6
53	2015	Dec	63.3	59.8	3588994	3390015	198979	5.5
53	2016	Jan	63.4	59.9	3601379	3402586	198793	5.5
53	2016	Feb	63.5	60	3612356	3414157	198199	5.5
53	2016	Mar	63.6	60.1	3621268	3424072	197196	5.4
53	2016	Apr	63.6	60.2	3628467	3432445	196022	5.4
53	2016	May	63.6	60.2	3635018	3440149	194869	5.4
53	2016	Jun	63.6	60.3	3641664	3448020	193644	5.3
53	2016	Jul	63.6	60.3	3648670	3456538	192132	5.3
53	2016	Aug	63.7	60.3	3655911	3465572	190339	5.2
53	2016	Sep	63.7	60.4	3663038	3474601	188437	5.1
53	2016	Oct	63.7	60.4	3669448	3483118	186330	5.1
53	2016	Nov	63.7	60.5	3675229	3491362	183867	5
53	2016	Dec	63.7	60.5	3681023	3499749	181274	4.9
53	2017	Jan	63.7	60.6	3687410	3508427	178983	4.9
53	2017	Feb	63.7	60.6	3694700	3517567	177133	4.8
53	2017	Mar	63.7	60.7	3702713	3526769	175944	4.8
53	2017	Apr	63.8	60.8	3711308	3535824	175484	4.7
53	2017	May	63.8	60.8	3719971	3544553	175418	4.7
53	2017	Jun	63.9	60.9	3727894	3552475	175419	4.7
53	2017	Jul	63.9	60.9	3734579	3559278	175301	4.7
53	2017	Aug	63.9	60.9	3739701	3564798	174903	4.7
53	2017	Sep	63.9	60.9	3743691	3569425	174266	4.7
53	2017	Oct	63.8	60.9	3747458	3573959	173499	4.6
53	2017	Nov	63.8	60.9	3751607	3578825	172782	4.6
53	2017	Dec	63.8	60.9	3756630	3584565	172065	4.6
53	2018	Jan	63.9	60.9	3762893	3591510	171383	4.6
53	2018	Feb	63.9	61	3770387	3599592	170795	4.5
53	2018	Mar	64	61.1	3778474	3608360	170114	4.5
53	2018	Apr	64	61.2	3785883	3616762	169121	4.5
53	2018	May	64	61.2	3792258	3624247	168011	4.4
53	2018	Jun	64.1	61.2	3798610	3631464	167146	4.4
53	2018	Jul	64.1	61.3	3805825	3639106	166719	4.4
53	2018	Aug	64.2	61.4	3814864	3647826	167038	4.4
53	2018	Sep	64.3	61.4	3825717	3657561	168156	4.4
53	2018	Oct	64.4	61.5	3837511	3667579	169932	4.4
53	2018	Nov	64.5	61.6	3849304	3677322	171982	4.5
53	2018	Dec	64.6	61.7	3860043	3686298	173745	4.5
53	2019	Jan	64.7	61.8	3868946	3694229	174717	4.5
53	2019	Feb	64.7	61.8	3875991	3701364	174627	4.5
53	2019	Mar	64.8	61.9	3882393	3708611	173782	4.5
53	2019	Apr	64.8	61.9	3889585	3717134	172451	4.4
53	2019	May	64.9	62	3898166	3727376	170790	4.4
53	2019	Jun	65	62.2	3908037	3739115	168922	4.3
53	2019	Jul	65.1	62.3	3919719	3753135	166584	4.2
53	2019	Aug	65.2	62.5	3930722	3766907	163815	4.2
53	2019	Sep	65.3	62.6	3940112	3779057	161055	4.1
53	2019	Oct	65.3	62.6	3946416	3787504	158912	4
53	2019	Nov	65.2	62.6	3946541	3788021	158520	4
53	2019	Dec	65.1	62.5	3945375	3786562	158813	4
53	2020	Jan	65.2	62.6	3955240	3799772	155468	3.9
53	2020	Feb	65.3	62.8	3962600	3810845	151755	3.8
54	2010	Jan	55.7	50.9	810979	741429	69550	8.6
54	2010	Feb	55.7	50.9	811352	741553	69799	8.6
54	2010	Mar	55.7	50.9	811333	741758	69575	8.6
54	2010	Apr	54.8	50.1	811023	741898	69125	8.5
54	2010	May	54.7	50.1	810631	741930	68701	8.5
54	2010	Jun	54.7	50	810305	741731	68574	8.5
54	2010	Jul	54.6	50	810258	741281	68977	8.5
54	2010	Aug	54.6	49.9	810584	740714	69870	8.6
54	2010	Sep	54.7	49.9	811033	740150	70883	8.7
54	2010	Oct	54.7	49.8	811378	739783	71595	8.8
54	2010	Nov	54.7	49.8	811476	739694	71782	8.8
54	2010	Dec	54.6	49.8	811158	739807	71351	8.8
54	2011	Jan	54.6	49.8	810420	740067	70353	8.7
54	2011	Feb	54.5	49.8	809255	740310	68945	8.5
54	2011	Mar	54.4	49.8	807674	740350	67324	8.3
54	2011	Apr	54.3	49.8	805973	740138	65835	8.2
54	2011	May	54.2	49.8	804653	739845	64808	8.1
54	2011	Jun	54.1	49.8	804111	739808	64303	8
54	2011	Jul	54.1	49.8	804494	740334	64160	8
54	2011	Aug	54.2	49.9	805556	741468	64088	8
54	2011	Sep	54.3	50	806802	743018	63784	7.9
54	2011	Oct	54.3	50.1	807723	744664	63059	7.8
54	2011	Nov	54.3	50.2	807925	746031	61894	7.7
54	2011	Dec	54.3	50.2	807497	746935	60562	7.5
54	2012	Jan	54.2	50.3	806904	747452	59452	7.4
54	2012	Feb	54.2	50.3	806692	747779	58913	7.3
54	2012	Mar	54.3	50.3	807060	747980	59080	7.3
54	2012	Apr	54.3	50.3	807745	747982	59763	7.4
54	2012	May	54.4	50.3	808536	747879	60657	7.5
54	2012	Jun	54.4	50.3	809176	747721	61455	7.6
54	2012	Jul	54.4	50.2	809458	747538	61920	7.6
54	2012	Aug	54.4	50.2	809418	747379	62039	7.7
54	2012	Sep	54.4	50.2	809186	747295	61891	7.6
54	2012	Oct	54.3	50.2	808673	747207	61466	7.6
54	2012	Nov	54.3	50.2	807834	747059	60775	7.5
54	2012	Dec	54.2	50.2	806563	746816	59747	7.4
54	2013	Jan	54.1	50.2	804599	746201	58398	7.3
54	2013	Feb	54	50.2	802673	745783	56890	7.1
54	2013	Mar	53.9	50.1	800945	745534	55411	6.9
54	2013	Apr	53.8	50.2	799753	745613	54140	6.8
54	2013	May	53.8	50.2	798997	745774	53223	6.7
54	2013	Jun	53.7	50.2	798464	745717	52747	6.6
54	2013	Jul	53.7	50.1	797952	745311	52641	6.6
54	2013	Aug	53.6	50.1	797285	744561	52724	6.6
54	2013	Sep	53.6	50	796583	743643	52940	6.6
54	2013	Oct	53.6	50	796163	742819	53344	6.7
54	2013	Nov	53.6	50	796140	742286	53854	6.8
54	2013	Dec	53.6	49.9	796384	742039	54345	6.8
54	2014	Jan	53.7	50	797245	742595	54650	6.9
54	2014	Feb	53.7	50	796881	742369	54512	6.8
54	2014	Mar	53.6	50	795812	741741	54071	6.8
54	2014	Apr	53.5	49.9	793946	740500	53446	6.7
54	2014	May	53.3	49.8	791576	738838	52738	6.7
54	2014	Jun	53.2	49.7	789173	737102	52071	6.6
54	2014	Jul	53	49.6	786998	735431	51567	6.6
54	2014	Aug	52.9	49.5	785214	733968	51246	6.5
54	2014	Sep	52.8	49.4	783758	732752	51006	6.5
54	2014	Oct	52.7	49.3	782472	731658	50814	6.5
54	2014	Nov	52.7	49.3	781369	730568	50801	6.5
54	2014	Dec	52.7	49.2	780638	729513	51125	6.5
54	2015	Jan	52.6	49.1	779937	728175	51762	6.6
54	2015	Feb	52.7	49.1	780294	727492	52802	6.8
54	2015	Mar	52.8	49.1	781163	727238	53925	6.9
54	2015	Apr	52.8	49.1	782246	727425	54821	7
54	2015	May	52.9	49.2	783039	727849	55190	7
54	2015	Jun	52.9	49.2	783146	728276	54870	7
54	2015	Jul	52.9	49.3	782598	728662	53936	6.9
54	2015	Aug	52.9	49.3	781703	729024	52679	6.7
54	2015	Sep	52.8	49.3	780938	729435	51503	6.6
54	2015	Oct	52.8	49.4	780717	730032	50685	6.5
54	2015	Nov	52.9	49.5	781075	730797	50278	6.4
54	2015	Dec	52.9	49.5	781797	731590	50207	6.4
54	2016	Jan	53	49.6	782601	732293	50308	6.4
54	2016	Feb	53.1	49.7	783165	732842	50323	6.4
54	2016	Mar	53.1	49.7	783326	733270	50056	6.4
54	2016	Apr	53.1	49.8	783171	733639	49532	6.3
54	2016	May	53.1	49.8	782961	734039	48922	6.2
54	2016	Jun	53.1	49.9	782852	734503	48349	6.2
54	2016	Jul	53.1	49.9	782797	734988	47809	6.1
54	2016	Aug	53.2	50	782636	735395	47241	6
54	2016	Sep	53.2	50	782160	735663	46497	5.9
54	2016	Oct	53.1	50	781278	735807	45471	5.8
54	2016	Nov	53.1	50.1	780202	735999	44203	5.7
54	2016	Dec	53	50.1	779111	736338	42773	5.5
54	2017	Jan	53	50.2	778115	736779	41336	5.3
54	2017	Feb	53	50.3	777364	737246	40118	5.2
54	2017	Mar	53	50.3	776921	737577	39344	5.1
54	2017	Apr	53	50.4	776906	737840	39066	5
54	2017	May	53.1	50.4	777311	738153	39158	5
54	2017	Jun	53.2	50.5	777991	738485	39506	5.1
54	2017	Jul	53.2	50.5	778851	738809	40042	5.1
54	2017	Aug	53.3	50.5	779701	739089	40612	5.2
54	2017	Sep	53.4	50.6	780391	739301	41090	5.3
54	2017	Oct	53.4	50.6	780894	739435	41459	5.3
54	2017	Nov	53.5	50.6	781184	739434	41750	5.3
54	2017	Dec	53.5	50.7	781433	739424	42009	5.4
54	2018	Jan	53.6	50.7	781862	739607	42255	5.4
54	2018	Feb	53.7	50.8	782563	740125	42438	5.4
54	2018	Mar	53.8	50.8	783406	740960	42446	5.4
54	2018	Apr	53.8	50.9	784056	741842	42214	5.4
54	2018	May	53.9	51	784408	742590	41818	5.3
54	2018	Jun	53.9	51.1	784602	743308	41294	5.3
54	2018	Jul	54	51.2	784789	744113	40676	5.2
54	2018	Aug	54	51.2	785214	745101	40113	5.1
54	2018	Sep	54.1	51.3	786047	746313	39734	5.1
54	2018	Oct	54.2	51.5	787220	747715	39505	5
54	2018	Nov	54.3	51.6	788515	749233	39282	5
54	2018	Dec	54.4	51.7	789633	750656	38977	4.9
54	2019	Jan	54.5	51.8	790389	751807	38582	4.9
54	2019	Feb	54.5	51.9	790807	752664	38143	4.8
54	2019	Mar	54.6	52	791185	753421	37764	4.8
54	2019	Apr	54.7	52.1	791876	754352	37524	4.7
54	2019	May	54.8	52.2	793046	755562	37484	4.7
54	2019	Jun	54.9	52.3	794739	757007	37732	4.7
54	2019	Jul	55.1	52.4	797083	758718	38365	4.8
54	2019	Aug	55.3	52.6	799495	760287	39208	4.9
54	2019	Sep	55.4	52.7	801633	761592	40041	5
54	2019	Oct	55.6	52.7	803070	762385	40685	5.1
54	2019	Nov	55.6	52.8	803129	762335	40794	5.1
54	2019	Dec	55.6	52.8	802879	762154	40725	5.1
54	2020	Jan	55.8	53	804830	764293	40537	5
54	2020	Feb	55.9	53.2	806517	766836	39681	4.9
55	2010	Jan	69.6	63.1	3083443	2797679	285764	9.3
55	2010	Feb	69.6	63.2	3086109	2801443	284666	9.2
55	2010	Mar	69.6	63.3	3087194	2806064	281130	9.1
55	2010	Apr	69.7	63.5	3086430	2810586	275844	8.9
55	2010	May	69.6	63.5	3084376	2814523	269853	8.7
55	2010	Jun	69.5	63.6	3081690	2817143	264547	8.6
55	2010	Jul	69.4	63.6	3079144	2818271	260873	8.5
55	2010	Aug	69.4	63.5	3077421	2818765	258656	8.4
55	2010	Sep	69.3	63.5	3076644	2819440	257204	8.4
55	2010	Oct	69.3	63.5	3076808	2821200	255608	8.3
55	2010	Nov	69.3	63.6	3077385	2824124	253261	8.2
55	2010	Dec	69.2	63.6	3077956	2827631	250325	8.1
55	2011	Jan	69.2	63.7	3078616	2831223	247393	8
55	2011	Feb	69.2	63.7	3079198	2834085	245113	8
55	2011	Mar	69.2	63.7	3079171	2835621	243550	7.9
55	2011	Apr	69.2	63.7	3078538	2835798	242740	7.9
55	2011	May	69.1	63.7	3078037	2835461	242576	7.9
55	2011	Jun	69.1	63.6	3078180	2835790	242390	7.9
55	2011	Jul	69.1	63.7	3079161	2837754	241407	7.8
55	2011	Aug	69.1	63.7	3080439	2841227	239212	7.8
55	2011	Sep	69	63.8	3081117	2845317	235800	7.7
55	2011	Oct	69	63.8	3080722	2849043	231679	7.5
55	2011	Nov	68.9	63.8	3078927	2851605	227322	7.4
55	2011	Dec	68.8	63.8	3076083	2852907	223176	7.3
55	2012	Jan	68.8	63.8	3073271	2853474	219797	7.2
55	2012	Feb	68.7	63.8	3071805	2853968	217837	7.1
55	2012	Mar	68.7	63.8	3071871	2854197	217674	7.1
55	2012	Apr	68.7	63.8	3072550	2853844	218706	7.1
55	2012	May	68.7	63.7	3073221	2853486	219735	7.1
55	2012	Jun	68.6	63.7	3073578	2853821	219757	7.1
55	2012	Jul	68.6	63.7	3073583	2855276	218307	7.1
55	2012	Aug	68.6	63.7	3073682	2857759	215923	7
55	2012	Sep	68.5	63.8	3074429	2860850	213579	6.9
55	2012	Oct	68.5	63.8	3075396	2863615	211781	6.9
55	2012	Nov	68.5	63.8	3076462	2865210	211252	6.9
55	2012	Dec	68.5	63.8	3077345	2865352	211993	6.9
55	2013	Jan	68.5	63.7	3078665	2864372	214293	7
55	2013	Feb	68.5	63.7	3078497	2863492	215005	7
55	2013	Mar	68.5	63.7	3078567	2864048	214519	7
55	2013	Apr	68.5	63.7	3079492	2866689	212803	6.9
55	2013	May	68.5	63.8	3080726	2870274	210452	6.8
55	2013	Jun	68.4	63.8	3081531	2873381	208150	6.8
55	2013	Jul	68.4	63.8	3081684	2875314	206370	6.7
55	2013	Aug	68.4	63.8	3080854	2876301	204553	6.6
55	2013	Sep	68.3	63.8	3079146	2877163	201983	6.6
55	2013	Oct	68.2	63.8	3077519	2878666	198853	6.5
55	2013	Nov	68.2	63.8	3076633	2881455	195178	6.3
55	2013	Dec	68.1	63.9	3076376	2885410	190966	6.2
55	2014	Jan	68.1	64	3075754	2888662	187092	6.1
55	2014	Feb	68.1	64	3075596	2893150	182446	5.9
55	2014	Mar	68.1	64.1	3075543	2897466	178077	5.8
55	2014	Apr	68	64.2	3075632	2901422	174210	5.7
55	2014	May	68	64.2	3076283	2905645	170638	5.5
55	2014	Jun	68	64.3	3078205	2911033	167172	5.4
55	2014	Jul	68.1	64.4	3081046	2917317	163729	5.3
55	2014	Aug	68.1	64.6	3084415	2923857	160558	5.2
55	2014	Sep	68.2	64.7	3087720	2929859	157861	5.1
55	2014	Oct	68.2	64.7	3089888	2934560	155328	5
55	2014	Nov	68.2	64.8	3090268	2937453	152815	4.9
55	2014	Dec	68.1	64.8	3089507	2938840	150667	4.9
55	2015	Jan	68.1	64.8	3087779	2938795	148984	4.8
55	2015	Feb	68	64.8	3086842	2939106	147736	4.8
55	2015	Mar	68	64.8	3086429	2939995	146434	4.7
55	2015	Apr	68	64.8	3086529	2941835	144694	4.7
55	2015	May	68	64.8	3086842	2944400	142442	4.6
55	2015	Jun	68	64.9	3087109	2947161	139948	4.5
55	2015	Jul	68	64.9	3087842	2950100	137742	4.5
55	2015	Aug	68	65	3089588	2953443	136145	4.4
55	2015	Sep	68	65	3092592	2957552	135040	4.4
55	2015	Oct	68.1	65.1	3097272	2962934	134338	4.3
55	2015	Nov	68.2	65.2	3103488	2969478	134010	4.3
55	2015	Dec	68.3	65.4	3110041	2976432	133609	4.3
55	2016	Jan	68.4	65.5	3115613	2982875	132738	4.3
55	2016	Feb	68.5	65.6	3119468	2988038	131430	4.2
55	2016	Mar	68.5	65.6	3121563	2991754	129809	4.2
55	2016	Apr	68.5	65.7	3122575	2994376	128199	4.1
55	2016	May	68.5	65.7	3123329	2996485	126844	4.1
55	2016	Jun	68.5	65.7	3124225	2998533	125692	4
55	2016	Jul	68.5	65.7	3125250	3000738	124512	4
55	2016	Aug	68.5	65.8	3126201	3002890	123311	3.9
55	2016	Sep	68.4	65.8	3126951	3004679	122272	3.9
55	2016	Oct	68.4	65.8	3127183	3006067	121116	3.9
55	2016	Nov	68.4	65.8	3126992	3007705	119287	3.8
55	2016	Dec	68.3	65.8	3126899	3010266	116633	3.7
55	2017	Jan	68.3	65.8	3127391	3013979	113412	3.6
55	2017	Feb	68.3	65.9	3128569	3018688	109881	3.5
55	2017	Mar	68.3	66	3130104	3023461	106643	3.4
55	2017	Apr	68.4	66.1	3132004	3027791	104213	3.3
55	2017	May	68.4	66.1	3134228	3031530	102698	3.3
55	2017	Jun	68.4	66.2	3136337	3034318	102019	3.3
55	2017	Jul	68.4	66.2	3137927	3036064	101863	3.2
55	2017	Aug	68.4	66.2	3138347	3036889	101458	3.2
55	2017	Sep	68.3	66.1	3137353	3037173	100180	3.2
55	2017	Oct	68.2	66.1	3135391	3037272	98119	3.1
55	2017	Nov	68.2	66.1	3132930	3037053	95877	3.1
55	2017	Dec	68.1	66	3130606	3036632	93974	3
55	2018	Jan	68	66	3129139	3036181	92958	3
55	2018	Feb	68	66	3128762	3035713	93049	3
55	2018	Mar	68	65.9	3128769	3034914	93855	3
55	2018	Apr	67.9	65.9	3127690	3033030	94660	3
55	2018	May	67.8	65.8	3124755	3029703	95052	3
55	2018	Jun	67.7	65.7	3120433	3025633	94800	3
55	2018	Jul	67.6	65.5	3115579	3021673	93906	3
55	2018	Aug	67.4	65.4	3111545	3018569	92976	3
55	2018	Sep	67.4	65.4	3109070	3016588	92482	3
55	2018	Oct	67.3	65.3	3108080	3015479	92601	3
55	2018	Nov	67.3	65.3	3108131	3014771	93360	3
55	2018	Dec	67.3	65.2	3108207	3013527	94680	3
55	2019	Jan	67.2	65.1	3107365	3011087	96278	3.1
55	2019	Feb	67.2	65	3105384	3007474	97910	3.2
55	2019	Mar	67.1	64.9	3103060	3003443	99617	3.2
55	2019	Apr	67	64.8	3101367	2999990	101377	3.3
55	2019	May	67	64.8	3100758	2997743	103015	3.3
55	2019	Jun	67	64.7	3101295	2996909	104386	3.4
55	2019	Jul	67	64.7	3103095	2997498	105597	3.4
55	2019	Aug	67	64.7	3104935	2998455	106480	3.4
55	2019	Sep	67	64.7	3106837	2999745	107092	3.4
55	2019	Oct	67	64.7	3108148	3000585	107563	3.5
55	2019	Nov	66.9	64.6	3108239	3000639	107600	3.5
55	2019	Dec	66.9	64.6	3108122	3000569	107553	3.5
55	2020	Jan	66.9	64.6	3110114	3000511	109603	3.5
55	2020	Feb	66.9	64.6	3109079	3000223	108856	3.5
56	2010	Jan	71.7	66.6	301774	280222	21552	7.1
56	2010	Feb	71.8	66.7	302123	280793	21330	7.1
56	2010	Mar	71.8	66.8	302337	281479	20858	6.9
56	2010	Apr	69.8	65.2	302446	282195	20251	6.7
56	2010	May	69.8	65.3	302531	282900	19631	6.5
56	2010	Jun	69.8	65.4	302704	283583	19121	6.3
56	2010	Jul	69.8	65.5	303001	284227	18774	6.2
56	2010	Aug	69.9	65.6	303421	284841	18580	6.1
56	2010	Sep	70	65.7	303969	285423	18546	6.1
56	2010	Oct	70.1	65.8	304600	285972	18628	6.1
56	2010	Nov	70.2	65.9	305218	286461	18757	6.1
56	2010	Dec	70.2	65.9	305701	286854	18847	6.2
56	2011	Jan	70.3	66	305969	287153	18816	6.1
56	2011	Feb	70.3	66	306064	287421	18643	6.1
56	2011	Mar	70.2	66	306066	287721	18345	6
56	2011	Apr	70.2	66.1	306051	288070	17981	5.9
56	2011	May	70.2	66.2	306102	288452	17650	5.8
56	2011	Jun	70.2	66.2	306270	288849	17421	5.7
56	2011	Jul	70.2	66.3	306582	289259	17323	5.7
56	2011	Aug	70.2	66.3	307001	289658	17343	5.6
56	2011	Sep	70.2	66.2	307425	290022	17403	5.7
56	2011	Oct	70.2	66.2	307757	290332	17425	5.7
56	2011	Nov	70.1	66.2	307944	290592	17352	5.6
56	2011	Dec	70	66.1	307983	290823	17160	5.6
56	2012	Jan	69.9	66.1	307909	291027	16882	5.5
56	2012	Feb	69.8	66	307765	291172	16593	5.4
56	2012	Mar	69.6	65.9	307605	291232	16373	5.3
56	2012	Apr	69.5	65.8	307476	291207	16269	5.3
56	2012	May	69.4	65.7	307387	291112	16275	5.3
56	2012	Jun	69.3	65.6	307332	290981	16351	5.3
56	2012	Jul	69.2	65.5	307263	290838	16425	5.3
56	2012	Aug	69.1	65.4	307166	290725	16441	5.4
56	2012	Sep	69	65.3	307068	290689	16379	5.3
56	2012	Oct	68.9	65.3	306980	290753	16227	5.3
56	2012	Nov	68.8	65.2	306920	290901	16019	5.2
56	2012	Dec	68.8	65.2	306883	291091	15792	5.1
56	2013	Jan	68.7	65.2	306849	291304	15545	5.1
56	2013	Feb	68.6	65.2	306804	291528	15276	5
56	2013	Mar	68.6	65.2	306746	291757	14989	4.9
56	2013	Apr	68.5	65.2	306679	291974	14705	4.8
56	2013	May	68.4	65.2	306617	292152	14465	4.7
56	2013	Jun	68.4	65.2	306561	292274	14287	4.7
56	2013	Jul	68.3	65.1	306532	292348	14184	4.6
56	2013	Aug	68.3	65.1	306522	292385	14137	4.6
56	2013	Sep	68.3	65.1	306498	292395	14103	4.6
56	2013	Oct	68.3	65.1	306442	292400	14042	4.6
56	2013	Nov	68.2	65.1	306338	292432	13906	4.5
56	2013	Dec	68.2	65.2	306198	292523	13675	4.5
56	2014	Jan	68.1	65.1	305825	292432	13393	4.4
56	2014	Feb	68.1	65.2	305785	292662	13123	4.3
56	2014	Mar	68.1	65.3	305801	292916	12885	4.2
56	2014	Apr	68.1	65.3	305880	293160	12720	4.2
56	2014	May	68.2	65.4	306008	293379	12629	4.1
56	2014	Jun	68.2	65.4	306172	293549	12623	4.1
56	2014	Jul	68.2	65.4	306316	293648	12668	4.1
56	2014	Aug	68.2	65.4	306355	293681	12674	4.1
56	2014	Sep	68.1	65.3	306253	293668	12585	4.1
56	2014	Oct	68.1	65.3	306036	293633	12403	4.1
56	2014	Nov	68	65.3	305775	293590	12185	4
56	2014	Dec	67.9	65.2	305527	293518	12009	3.9
56	2015	Jan	67.8	65.1	305125	293147	11978	3.9
56	2015	Feb	67.7	65.1	304974	292866	12108	4
56	2015	Mar	67.7	65	304861	292482	12379	4.1
56	2015	Apr	67.7	64.8	304751	292036	12715	4.2
56	2015	May	67.6	64.7	304602	291577	13025	4.3
56	2015	Jun	67.5	64.6	304380	291150	13230	4.3
56	2015	Jul	67.4	64.5	304080	290778	13302	4.4
56	2015	Aug	67.4	64.4	303764	290436	13328	4.4
56	2015	Sep	67.3	64.3	303488	290074	13414	4.4
56	2015	Oct	67.3	64.2	303291	289645	13646	4.5
56	2015	Nov	67.2	64.1	303212	289125	14087	4.6
56	2015	Dec	67.3	64	303261	288508	14753	4.9
56	2016	Jan	67.3	63.9	303381	287824	15557	5.1
56	2016	Feb	67.3	63.7	303454	287103	16351	5.4
56	2016	Mar	67.3	63.6	303335	286366	16969	5.6
56	2016	Apr	67.2	63.4	302924	285641	17283	5.7
56	2016	May	67.1	63.2	302195	284943	17252	5.7
56	2016	Jun	66.9	63.1	301187	284286	16901	5.6
56	2016	Jul	66.6	63	300061	283685	16376	5.5
56	2016	Aug	66.4	62.9	298981	283148	15833	5.3
56	2016	Sep	66.2	62.8	298032	282683	15349	5.2
56	2016	Oct	66.1	62.7	297247	282295	14952	5
56	2016	Nov	66	62.7	296564	281982	14582	4.9
56	2016	Dec	65.8	62.7	295893	281742	14151	4.8
56	2017	Jan	65.7	62.7	295208	281572	13636	4.6
56	2017	Feb	65.6	62.7	294529	281452	13077	4.4
56	2017	Mar	65.5	62.7	293902	281354	12548	4.3
56	2017	Apr	65.5	62.8	293398	281264	12134	4.1
56	2017	May	65.4	62.8	293071	281175	11896	4.1
56	2017	Jun	65.4	62.8	292919	281071	11848	4
56	2017	Jul	65.4	62.8	292842	280937	11905	4.1
56	2017	Aug	65.4	62.7	292734	280774	11960	4.1
56	2017	Sep	65.4	62.7	292566	280584	11982	4.1
56	2017	Oct	65.3	62.6	292320	280372	11948	4.1
56	2017	Nov	65.2	62.6	292024	280158	11866	4.1
56	2017	Dec	65.2	62.5	291730	279971	11759	4
56	2018	Jan	65.1	62.5	291480	279834	11646	4
56	2018	Feb	65.1	62.5	291319	279768	11551	4
56	2018	Mar	65.1	62.5	291252	279766	11486	3.9
56	2018	Apr	65.1	62.5	291237	279782	11455	3.9
56	2018	May	65.1	62.5	291244	279789	11455	3.9
56	2018	Jun	65.1	62.5	291278	279808	11470	3.9
56	2018	Jul	65.1	62.5	291346	279865	11481	3.9
56	2018	Aug	65.1	62.5	291434	279981	11453	3.9
56	2018	Sep	65	62.5	291506	280171	11335	3.9
56	2018	Oct	65	62.5	291554	280435	11119	3.8
56	2018	Nov	65	62.6	291572	280731	10841	3.7
56	2018	Dec	65	62.6	291555	281011	10544	3.6
56	2019	Jan	65	62.7	291512	281239	10273	3.5
56	2019	Feb	64.9	62.7	291491	281400	10091	3.5
56	2019	Mar	64.9	62.7	291572	281521	10051	3.4
56	2019	Apr	64.9	62.7	291796	281644	10152	3.5
56	2019	May	65	62.7	292132	281782	10350	3.5
56	2019	Jun	65	62.7	292490	281906	10584	3.6
56	2019	Jul	65.1	62.7	292785	281998	10787	3.7
56	2019	Aug	65.1	62.7	292901	281995	10906	3.7
56	2019	Sep	65	62.6	292889	281961	10928	3.7
56	2019	Oct	65	62.6	292785	281900	10885	3.7
56	2019	Nov	64.9	62.5	292684	281856	10828	3.7
56	2019	Dec	64.9	62.5	292662	281857	10805	3.7
56	2020	Jan	65	62.6	293281	282542	10739	3.7
56	2020	Feb	65.2	62.8	294173	283295	10878	3.7
